MC_ID	scf	start	end	length	num_mods	present_at_promoter	proteinIds	protein_strand
1	scaffold_12	3401	3420	19	6	no	NA	NA
2	scaffold_12	10758	11209	451	37	yes	314191	+
3	scaffold_12	36747	37781	1034	45	yes	292443	+
4	scaffold_12	50600	51837	1237	147	no	NA	NA
5	scaffold_12	52561	53491	930	105	yes	403088	-
6	scaffold_12	63209	63244	35	7	no	NA	NA
7	scaffold_12	70148	70163	15	6	no	NA	NA
8	scaffold_12	70275	71648	1373	114	no	NA	NA
9	scaffold_12	76756	77793	1037	115	yes	314204	+
10	scaffold_12	79375	81025	1650	146	yes	314206	-
11	scaffold_12	81331	82706	1375	157	yes	314206,423613	-,-
12	scaffold_12	87034	88533	1499	218	yes	314209	-
13	scaffold_12	99956	101876	1920	180	yes	314211	-
14	scaffold_12	111078	112151	1073	124	no	NA	NA
15	scaffold_12	118898	119807	909	103	yes	292451	-
16	scaffold_12	128324	129068	744	61	no	NA	NA
17	scaffold_12	129951	129958	7	4	no	NA	NA
18	scaffold_12	131523	132990	1467	159	yes	403104	+
19	scaffold_12	138773	140153	1380	87	yes	403105	+
20	scaffold_12	143337	143929	592	53	no	NA	NA
21	scaffold_12	155235	156372	1137	121	no	NA	NA
22	scaffold_12	160014	160480	466	70	no	NA	NA
23	scaffold_12	160731	160775	44	5	no	NA	NA
24	scaffold_12	163699	165181	1482	189	yes	314241	+
25	scaffold_12	180553	181714	1161	98	yes	390290	-
26	scaffold_12	184491	185511	1020	96	yes	403115	+
27	scaffold_12	188466	189447	981	112	yes	314249	-
28	scaffold_12	197782	198437	655	67	yes	314250	-
29	scaffold_12	199531	200752	1221	122	no	NA	NA
30	scaffold_12	203418	204359	941	89	yes	390294	+
31	scaffold_12	208993	210194	1201	128	yes	314257	-
32	scaffold_12	211032	211954	922	58	yes	423635	+
33	scaffold_12	224556	224705	149	17	yes	390299	+
34	scaffold_12	225086	225179	93	14	yes	390299	+
35	scaffold_12	225470	225562	92	16	no	NA	NA
36	scaffold_12	230574	231386	812	69	yes	390300	-
37	scaffold_12	233268	233479	211	26	yes	30096	+
38	scaffold_12	233585	234272	687	61	yes	30096	+
39	scaffold_12	239066	240084	1018	120	yes	292476,390302	-,-
40	scaffold_12	245525	245552	27	5	no	NA	NA
41	scaffold_12	246020	247367	1347	151	yes	314263	-
42	scaffold_12	248997	250075	1078	112	yes	314265	+
43	scaffold_12	260257	261288	1031	95	yes	423644	-
44	scaffold_12	265557	266852	1295	116	yes	390309	+
45	scaffold_12	272598	273953	1355	145	yes	390310	+
46	scaffold_12	274069	274280	211	9	yes	390310	+
47	scaffold_12	299432	299528	96	10	no	NA	NA
48	scaffold_12	304601	305724	1123	124	yes	292487	-
49	scaffold_12	313587	314389	802	108	no	NA	NA
50	scaffold_12	323101	323803	702	50	yes	30315	+
51	scaffold_12	324093	324107	14	4	yes	30315	+
52	scaffold_12	326505	327404	899	68	no	NA	NA
53	scaffold_12	327610	327625	15	4	no	NA	NA
54	scaffold_12	330322	330348	26	6	no	NA	NA
55	scaffold_12	332505	333134	629	61	yes	314289	-
56	scaffold_12	358758	359689	931	67	no	NA	NA
57	scaffold_12	367517	368860	1343	166	no	NA	NA
58	scaffold_12	374856	376259	1403	129	yes	314310	-
59	scaffold_12	382944	383588	644	78	yes	390320	+
60	scaffold_12	394664	396070	1406	145	yes	403155	-
61	scaffold_12	406839	408076	1237	132	yes	385244	+
62	scaffold_12	409783	410982	1199	174	yes	314320	+
63	scaffold_12	418071	419330	1259	92	yes	314322	-
64	scaffold_12	423845	425461	1616	233	no	NA	NA
65	scaffold_12	425693	425700	7	4	no	NA	NA
66	scaffold_12	434485	435296	811	84	yes	423665	-
67	scaffold_12	435390	436178	788	71	yes	423665	-
68	scaffold_12	450158	450930	772	91	no	NA	NA
69	scaffold_12	460294	460956	662	43	yes	292507	-
70	scaffold_12	464849	466146	1297	120	yes	390332	+
71	scaffold_12	471636	472816	1180	102	yes	216565	-
72	scaffold_12	490405	490440	35	4	no	NA	NA
73	scaffold_12	490637	491365	728	52	yes	423675	-
74	scaffold_12	507499	508892	1393	190	yes	314345	+
75	scaffold_12	512459	513153	694	64	yes	30685	+
76	scaffold_12	518608	520481	1873	132	yes	292521	-
77	scaffold_12	525621	526851	1230	89	yes	390342	-
78	scaffold_12	533813	535322	1509	117	yes	30737	-
79	scaffold_12	539658	540567	909	97	yes	230329	-
80	scaffold_12	566490	567822	1332	102	yes	314357	-
81	scaffold_12	629907	629932	25	6	no	NA	NA
82	scaffold_12	723329	724190	861	94	yes	314374	+
83	scaffold_12	731084	732564	1480	120	yes	390351	+
84	scaffold_12	742108	743068	960	81	yes	368646	-
85	scaffold_12	766461	769740	3279	267	yes	423698	+
86	scaffold_12	775670	775717	47	12	yes	314388	+
87	scaffold_12	776766	777259	493	53	no	NA	NA
88	scaffold_12	784622	785593	971	88	no	NA	NA
89	scaffold_12	792302	793106	804	83	yes	292565,292566	-,+
90	scaffold_12	797119	797250	131	17	yes	314394	+
91	scaffold_12	817251	818041	790	66	yes	314404	+
92	scaffold_12	847003	847681	678	74	yes	314409	+
93	scaffold_12	855803	855926	123	20	yes	314412	+
94	scaffold_12	867656	867676	20	8	yes	242909	+
95	scaffold_12	893204	894296	1092	161	yes	423718	+
96	scaffold_12	897179	897641	462	33	yes	423719	+
97	scaffold_12	905411	906130	719	122	yes	31105	+
98	scaffold_12	910058	910803	745	78	yes	403274	+
99	scaffold_12	930055	930129	74	18	no	NA	NA
100	scaffold_12	930227	931051	824	82	no	NA	NA
101	scaffold_12	937473	937490	17	5	no	NA	NA
102	scaffold_12	937688	939523	1835	200	yes	423725	+
103	scaffold_12	946940	947585	645	55	yes	314437	+
104	scaffold_12	960789	960808	19	7	no	NA	NA
105	scaffold_12	979865	980792	927	100	no	NA	NA
106	scaffold_12	985586	989091	3505	216	yes	31186,314448	+,-
107	scaffold_12	1007495	1007773	278	23	yes	390392	-
108	scaffold_12	1026906	1028003	1097	101	yes	314458	-
109	scaffold_12	1028981	1030022	1041	106	yes	423742	+
110	scaffold_12	1034924	1034940	16	6	yes	314460	+
111	scaffold_12	1040709	1041369	660	56	yes	314462	+
112	scaffold_12	1074462	1075367	905	88	yes	314465	-
113	scaffold_12	1100230	1101063	833	106	no	NA	NA
114	scaffold_12	1101165	1101208	43	9	no	NA	NA
115	scaffold_12	1103340	1103358	18	4	no	NA	NA
116	scaffold_12	1103776	1104924	1148	170	no	NA	NA
117	scaffold_12	1104992	1105027	35	8	no	NA	NA
118	scaffold_12	1114214	1114403	189	27	no	NA	NA
119	scaffold_12	1120954	1120983	29	7	yes	314475	+
120	scaffold_12	1121090	1121133	43	10	yes	314475	+
121	scaffold_12	1121461	1122499	1038	144	yes	314475	+
122	scaffold_12	1135705	1137257	1552	157	yes	423758,423759	+,+
123	scaffold_12	1140023	1140950	927	105	yes	314482	+
124	scaffold_12	1141084	1141093	9	4	no	NA	NA
125	scaffold_12	1147064	1147077	13	4	no	NA	NA
126	scaffold_12	1147214	1147594	380	38	no	NA	NA
127	scaffold_12	1150326	1151515	1189	167	yes	292631	-
128	scaffold_12	1167146	1168184	1038	125	yes	314497	+
129	scaffold_12	1179119	1179132	13	4	no	NA	NA
130	scaffold_12	1179269	1179644	375	36	yes	31461	-
131	scaffold_12	1181269	1182886	1617	225	yes	292636	-
132	scaffold_12	1185064	1185080	16	4	no	NA	NA
133	scaffold_12	1185379	1186545	1166	174	no	NA	NA
134	scaffold_12	1198104	1199233	1129	116	yes	242937	-
135	scaffold_12	1203781	1205113	1332	137	yes	314513	-
136	scaffold_12	1210960	1212169	1209	107	yes	423771	-
137	scaffold_12	1247451	1248480	1029	115	no	NA	NA
138	scaffold_12	1276393	1277385	992	130	yes	314526	+
139	scaffold_12	1289444	1289457	13	4	no	NA	NA
140	scaffold_12	1289598	1290405	807	104	no	NA	NA
141	scaffold_12	1292026	1292952	926	91	yes	314529	-
142	scaffold_12	1298733	1300142	1409	118	yes	314531	-
143	scaffold_12	1300960	1301099	139	10	no	NA	NA
144	scaffold_12	1301395	1304114	2719	292	yes	31680,292658	-,-
145	scaffold_2	14487	15578	1091	106	yes	306170	-
146	scaffold_2	21973	23547	1574	123	yes	387104	-
147	scaffold_2	27003	28230	1227	183	yes	306179	+
148	scaffold_2	33286	34440	1154	138	yes	57164	-
149	scaffold_2	45389	45790	401	65	no	NA	NA
150	scaffold_2	46184	46563	379	46	no	NA	NA
151	scaffold_2	46751	47363	612	44	yes	306182,306183	-,+
152	scaffold_2	53243	54317	1074	51	yes	306184	-
153	scaffold_2	67151	67500	349	40	no	NA	NA
154	scaffold_2	79738	79949	211	31	yes	306188	-
155	scaffold_2	84139	84574	435	37	no	NA	NA
156	scaffold_2	84670	84709	39	10	no	NA	NA
157	scaffold_2	96717	97332	615	88	yes	306224	+
158	scaffold_2	102682	103934	1252	87	yes	306226	-
159	scaffold_2	109727	111233	1506	164	no	NA	NA
160	scaffold_2	111304	111362	58	8	no	NA	NA
161	scaffold_2	121409	122537	1128	85	yes	405614	-
162	scaffold_2	125701	126506	805	102	yes	306238	-
163	scaffold_2	135411	135440	29	3	no	NA	NA
164	scaffold_2	140675	141530	855	63	yes	288703	-
165	scaffold_2	144393	145740	1347	134	yes	306258	+
166	scaffold_2	148881	150282	1401	147	yes	420470	-
167	scaffold_2	151606	153356	1750	177	yes	306260	+
168	scaffold_2	163434	165029	1595	140	no	NA	NA
169	scaffold_2	171894	172673	779	75	yes	306270	+
170	scaffold_2	176520	176557	37	10	no	NA	NA
171	scaffold_2	176846	177087	241	29	yes	420477,420478	-,+
172	scaffold_2	177249	178548	1299	168	yes	420477,420478	-,+
173	scaffold_2	185657	186344	687	74	yes	213355	-
174	scaffold_2	196303	197123	820	82	yes	213189	+
175	scaffold_2	206033	207533	1500	180	yes	306297	-
176	scaffold_2	207780	208816	1036	114	yes	306297,306304	-,+
177	scaffold_2	214457	215468	1011	99	yes	405640	-
178	scaffold_2	216036	218776	2740	262	yes	306309,306311,387136	+,-,+
179	scaffold_2	219018	220076	1058	152	yes	306311,387136	-,+
180	scaffold_2	222352	223637	1285	135	yes	57715	+
181	scaffold_2	231741	232769	1028	108	yes	405645	-
182	scaffold_2	233444	234701	1257	101	yes	227129	+
183	scaffold_2	240417	241820	1403	152	yes	364909	-
184	scaffold_2	244147	246137	1990	196	yes	306320	-
185	scaffold_2	250746	251828	1082	158	yes	420496	+
186	scaffold_2	268004	269244	1240	96	yes	288732	+
187	scaffold_2	297051	298194	1143	55	yes	57901	-
188	scaffold_2	303756	303915	159	22	no	NA	NA
189	scaffold_2	316249	317454	1205	97	yes	306348	+
190	scaffold_2	319627	321145	1518	210	yes	306351	-
191	scaffold_2	321571	323276	1705	165	yes	306351,364912	-,+
192	scaffold_2	331306	333172	1866	191	yes	306356	-
193	scaffold_2	343760	344958	1198	165	yes	387165	+
194	scaffold_2	349199	350238	1039	114	yes	420515	+
195	scaffold_2	353365	354299	934	144	yes	306368	-
196	scaffold_2	355961	356930	969	94	yes	306371	-
197	scaffold_2	363398	364617	1219	118	no	NA	NA
198	scaffold_2	377176	377697	521	44	no	NA	NA
199	scaffold_2	383733	384162	429	20	yes	288755	-
200	scaffold_2	393757	394931	1174	131	yes	58124	+
201	scaffold_2	397038	397056	18	4	no	NA	NA
202	scaffold_2	397386	398423	1037	126	yes	420522	-
203	scaffold_2	398535	398572	37	12	yes	420522	-
204	scaffold_2	399706	401763	2057	173	yes	405685	+
205	scaffold_2	411304	413320	2016	234	no	NA	NA
206	scaffold_2	414095	415220	1125	114	yes	58195,306389	+,-
207	scaffold_2	415409	416269	860	78	yes	58195,306389	+,-
208	scaffold_2	429016	429990	974	102	yes	420528	-
209	scaffold_2	438781	439459	678	62	yes	405694	+
210	scaffold_2	442589	444143	1554	164	yes	387184	-
211	scaffold_2	446030	447325	1295	122	yes	364919	-
212	scaffold_2	454249	455247	998	133	yes	420533	-
213	scaffold_2	461192	462347	1155	163	no	NA	NA
214	scaffold_2	463522	464436	914	76	yes	306409,371277	+,-
215	scaffold_2	467271	468442	1171	109	yes	387188	-
216	scaffold_2	469626	470565	939	105	yes	306414	+
217	scaffold_2	473278	474511	1233	165	yes	306416	+
218	scaffold_2	476089	477068	979	144	yes	306418	+
219	scaffold_2	479226	479946	720	82	yes	306421	-
220	scaffold_2	480885	482091	1206	116	yes	288781	+
221	scaffold_2	482237	482247	10	4	no	NA	NA
222	scaffold_2	487093	488448	1355	128	yes	405707	-
223	scaffold_2	489872	490749	877	105	yes	306429	-
224	scaffold_2	494148	495149	1001	101	yes	387196	+
225	scaffold_2	508847	508898	51	3	no	NA	NA
226	scaffold_2	509018	510113	1095	122	no	NA	NA
227	scaffold_2	510202	510249	47	8	no	NA	NA
228	scaffold_2	517241	518822	1581	141	no	NA	NA
229	scaffold_2	522827	523994	1167	119	yes	306443	+
230	scaffold_2	526841	528344	1503	161	yes	58474	-
231	scaffold_2	528526	529626	1100	77	yes	58474,306448	-,-
232	scaffold_2	535693	535767	74	12	yes	387202	-
233	scaffold_2	543036	544146	1110	79	yes	58493	+
234	scaffold_2	548608	548989	381	24	no	NA	NA
235	scaffold_2	552971	554419	1448	188	yes	420550	-
236	scaffold_2	556738	558055	1317	111	yes	387206	+
237	scaffold_2	568201	568997	796	80	yes	387207	-
238	scaffold_2	579757	579955	198	17	yes	387208	-
239	scaffold_2	582098	583452	1354	188	yes	420554	+
240	scaffold_2	590660	592275	1615	196	yes	58642	-
241	scaffold_2	596461	597497	1036	52	yes	306471	-
242	scaffold_2	601690	601701	11	4	no	NA	NA
243	scaffold_2	602512	603431	919	79	yes	306473	-
244	scaffold_2	610437	611342	905	90	yes	306476	-
245	scaffold_2	614902	614948	46	4	yes	387215	-
246	scaffold_2	615030	616096	1066	122	yes	387215	-
247	scaffold_2	623048	624179	1131	131	yes	420562	+
248	scaffold_2	640638	641901	1263	123	yes	384755	-
249	scaffold_2	642537	643412	875	117	yes	213392	+
250	scaffold_2	649246	649747	501	49	yes	420567	-
251	scaffold_2	652984	654160	1176	158	no	NA	NA
252	scaffold_2	660314	660875	561	42	yes	405740	-
253	scaffold_2	663104	663761	657	91	yes	306492	+
254	scaffold_2	665093	665830	737	72	no	NA	NA
255	scaffold_2	672904	673719	815	74	yes	420572	+
256	scaffold_2	676219	677148	929	122	yes	306497	+
257	scaffold_2	688499	689496	997	111	yes	306505	-
258	scaffold_2	696897	698102	1205	171	yes	239874	-
259	scaffold_2	711593	713012	1419	138	no	NA	NA
260	scaffold_2	744446	745248	802	114	yes	288831	-
261	scaffold_2	745395	745576	181	16	yes	288831	-
262	scaffold_2	748401	749354	953	99	yes	213179	-
263	scaffold_2	761995	762593	598	50	no	NA	NA
264	scaffold_2	768510	769168	658	83	no	NA	NA
265	scaffold_2	769870	770234	364	47	yes	306532	+
266	scaffold_2	770466	770482	16	4	no	NA	NA
267	scaffold_2	773128	773733	605	52	no	NA	NA
268	scaffold_2	777657	778668	1011	109	yes	405769	-
269	scaffold_2	785546	786503	957	84	yes	59130	-
270	scaffold_2	789705	790301	596	46	yes	306541	-
271	scaffold_2	799447	800914	1467	151	yes	364928	+
272	scaffold_2	802922	804020	1098	121	yes	306548	+
273	scaffold_2	807274	808697	1423	155	yes	306549	-
274	scaffold_2	809310	810763	1453	173	no	NA	NA
275	scaffold_2	810862	812287	1425	174	yes	59238	-
276	scaffold_2	821220	822382	1162	101	yes	306553	-
277	scaffold_2	824476	825675	1199	127	no	NA	NA
278	scaffold_2	870991	871626	635	48	no	NA	NA
279	scaffold_2	910820	911291	471	33	no	NA	NA
280	scaffold_2	921925	923152	1227	121	yes	371344	-
281	scaffold_2	925829	926964	1135	87	yes	62553,306636	-,-
282	scaffold_2	929602	931209	1607	142	yes	306638	-
283	scaffold_2	937098	938402	1304	94	yes	306641	+
284	scaffold_2	941444	942564	1120	126	yes	213470,227274	-,+
285	scaffold_2	942754	944057	1303	173	yes	227274	+
286	scaffold_2	948650	949984	1334	115	yes	306644	-
287	scaffold_2	960737	962434	1697	120	yes	239931	-
288	scaffold_2	970240	971296	1056	103	yes	405801	-
289	scaffold_2	974125	975188	1063	125	yes	387272	+
290	scaffold_2	991519	993069	1550	186	yes	306671	+
291	scaffold_2	999466	1001223	1757	188	yes	62761	-
292	scaffold_2	1024860	1026628	1768	205	yes	306683	-
293	scaffold_2	1029552	1030547	995	90	yes	306686	-
294	scaffold_2	1034213	1035500	1287	207	no	NA	NA
295	scaffold_2	1065074	1065764	690	70	yes	420631	+
296	scaffold_2	1070341	1071113	772	93	no	NA	NA
297	scaffold_2	1071247	1071298	51	12	no	NA	NA
298	scaffold_2	1071405	1071430	25	6	no	NA	NA
299	scaffold_2	1079253	1080087	834	86	yes	387291	+
300	scaffold_2	1134133	1134841	708	99	no	NA	NA
301	scaffold_2	1137440	1137451	11	4	yes	239981	+
302	scaffold_2	1137756	1137794	38	14	yes	239981	+
303	scaffold_2	1154083	1155626	1543	141	yes	420647	-
304	scaffold_2	1164086	1164100	14	6	no	NA	NA
305	scaffold_2	1170818	1172124	1306	148	yes	420649	-
306	scaffold_2	1191755	1193309	1554	173	no	NA	NA
307	scaffold_2	1201536	1202155	619	78	yes	306748	+
308	scaffold_2	1217009	1217918	909	84	yes	420657	-
309	scaffold_2	1222069	1222667	598	73	yes	420658	-
310	scaffold_2	1224441	1224477	36	8	no	NA	NA
311	scaffold_2	1224580	1225577	997	102	yes	306758	-
312	scaffold_2	1229142	1229151	9	4	no	NA	NA
313	scaffold_2	1229251	1229693	442	47	yes	63133	-
314	scaffold_2	1232033	1232481	448	58	no	NA	NA
315	scaffold_2	1234689	1235432	743	101	yes	420660	-
316	scaffold_2	1236565	1237420	855	63	yes	306763	+
317	scaffold_2	1239746	1240119	373	35	yes	288924	-
318	scaffold_2	1243339	1243375	36	10	no	NA	NA
319	scaffold_2	1243507	1243554	47	10	no	NA	NA
320	scaffold_2	1243657	1243735	78	6	no	NA	NA
321	scaffold_2	1243863	1243965	102	14	no	NA	NA
322	scaffold_2	1257128	1257516	388	47	yes	306766	-
323	scaffold_2	1268342	1268971	629	54	yes	306769	+
324	scaffold_2	1275313	1276731	1418	130	yes	213301	-
325	scaffold_2	1283414	1284565	1151	119	no	NA	NA
326	scaffold_2	1292942	1294374	1432	94	yes	213710	+
327	scaffold_2	1316478	1316494	16	4	yes	306777	-
328	scaffold_2	1323339	1324628	1289	130	yes	288942	-
329	scaffold_2	1334105	1334914	809	57	yes	227357	-
330	scaffold_2	1347086	1347935	849	105	yes	384769	-
331	scaffold_2	1372308	1373870	1562	189	no	NA	NA
332	scaffold_2	1376254	1377149	895	100	yes	306796	-
333	scaffold_2	1386362	1387539	1177	55	yes	405897	+
334	scaffold_2	1390892	1391971	1079	147	no	NA	NA
335	scaffold_2	1393294	1394438	1144	70	yes	405898	+
336	scaffold_2	1396422	1397476	1054	110	yes	306801	+
337	scaffold_2	1401513	1402729	1216	119	yes	306802	+
338	scaffold_2	1410151	1411060	909	80	yes	306805	-
339	scaffold_2	1414986	1416483	1497	123	yes	420688	-
340	scaffold_2	1421896	1422205	309	21	yes	288960	-
341	scaffold_2	1429503	1430882	1379	162	yes	306812	+
342	scaffold_2	1434065	1435404	1339	191	yes	306813	+
343	scaffold_2	1440614	1441649	1035	104	yes	63552	+
344	scaffold_2	1442173	1443848	1675	172	yes	306817,364937	-,+
345	scaffold_2	1446613	1447338	725	71	yes	306818	+
346	scaffold_2	1454955	1455890	935	111	yes	420694	+
347	scaffold_2	1460550	1461764	1214	167	no	NA	NA
348	scaffold_2	1466517	1466923	406	56	no	NA	NA
349	scaffold_2	1472590	1472615	25	6	yes	63619	+
350	scaffold_2	1478575	1480180	1605	131	yes	420699	+
351	scaffold_2	1482035	1482312	277	12	no	NA	NA
352	scaffold_2	1484020	1484340	320	16	no	NA	NA
353	scaffold_2	1487394	1488807	1413	172	yes	405918	-
354	scaffold_2	1495160	1496415	1255	141	yes	63699,213330	+,+
355	scaffold_2	1499846	1500274	428	18	yes	420704	+
356	scaffold_2	1500432	1500598	166	16	yes	420704	+
357	scaffold_2	1521120	1521141	21	8	yes	63735	+
358	scaffold_2	1530861	1531344	483	58	no	NA	NA
359	scaffold_2	1533016	1533083	67	10	yes	306842	-
360	scaffold_2	1535891	1537176	1285	162	yes	306846	+
361	scaffold_2	1541759	1543443	1684	186	yes	306852	-
362	scaffold_2	1547012	1548338	1326	121	yes	288993,306859	-,+
363	scaffold_2	1566208	1566896	688	48	yes	405941	-
364	scaffold_2	1593170	1594380	1210	117	yes	306870	-
365	scaffold_2	1596278	1597967	1689	198	yes	63944,306880	+,+
366	scaffold_2	1602881	1604423	1542	208	yes	240051	+
367	scaffold_2	1611174	1611549	375	28	yes	306884	-
368	scaffold_2	1620104	1621139	1035	109	yes	213852	+
369	scaffold_2	1624746	1626210	1464	169	yes	289013	+
370	scaffold_2	1626412	1626419	7	4	no	NA	NA
371	scaffold_2	1637913	1639065	1152	127	yes	306892	-
372	scaffold_2	1640391	1641302	911	72	yes	420727	-
373	scaffold_2	1643059	1644705	1646	135	yes	227413	+
374	scaffold_2	1659789	1661455	1666	199	no	NA	NA
375	scaffold_2	1662728	1663700	972	77	yes	306904	+
376	scaffold_2	1663891	1665763	1872	144	yes	306906	-
377	scaffold_2	1669798	1669808	10	4	yes	289023	-
378	scaffold_2	1670054	1670970	916	74	yes	289023	-
379	scaffold_2	1674514	1674522	8	4	no	NA	NA
380	scaffold_2	1675551	1676534	983	121	yes	227425	-
381	scaffold_2	1677520	1679302	1782	182	yes	64182	-
382	scaffold_2	1686906	1687661	755	76	yes	306910	-
383	scaffold_2	1690380	1691708	1328	124	yes	289027	-
384	scaffold_2	1692502	1693679	1177	160	yes	306917	+
385	scaffold_2	1694787	1695945	1158	129	yes	306921	+
386	scaffold_2	1699350	1700367	1017	70	yes	64277	-
387	scaffold_2	1701417	1702970	1553	162	yes	306925	-
388	scaffold_2	1706068	1706074	6	4	no	NA	NA
389	scaffold_2	1706324	1707386	1062	133	yes	306927,306928	-,+
390	scaffold_2	1707744	1709041	1297	156	yes	306927,306928	-,+
391	scaffold_2	1717784	1719152	1368	166	yes	405974	-
392	scaffold_2	1721042	1722340	1298	112	yes	405975	+
393	scaffold_2	1730586	1731587	1001	114	yes	405976	+
394	scaffold_2	1741764	1742714	950	60	yes	420746	+
395	scaffold_2	1748025	1749161	1136	151	yes	64429	-
396	scaffold_2	1750189	1751261	1072	118	yes	64431	+
397	scaffold_2	1755122	1756682	1560	195	yes	306942	-
398	scaffold_2	1768848	1769592	744	69	yes	387404	-
399	scaffold_2	1776588	1777472	884	93	no	NA	NA
400	scaffold_2	1802153	1802393	240	34	yes	405991	-
401	scaffold_2	1869079	1870475	1396	160	yes	387411	-
402	scaffold_2	1872822	1874364	1542	161	yes	289054	-
403	scaffold_2	1876683	1878038	1355	114	yes	420758	-
404	scaffold_2	1886321	1887478	1157	94	yes	306963	-
405	scaffold_2	1889977	1891656	1679	189	yes	213635	+
406	scaffold_2	1897002	1898235	1233	169	yes	306967	+
407	scaffold_2	1898428	1898570	142	15	no	NA	NA
408	scaffold_2	1907544	1908973	1429	147	yes	406010	-
409	scaffold_2	1909606	1910422	816	82	no	NA	NA
410	scaffold_2	1912230	1912827	597	50	yes	306971,306974	-,+
411	scaffold_2	1913113	1914336	1223	142	yes	306971,306974	-,+
412	scaffold_2	1917010	1917450	440	48	yes	306975	+
413	scaffold_2	1919169	1920168	999	95	yes	64688	+
414	scaffold_2	1922129	1922230	101	12	no	NA	NA
415	scaffold_2	1924212	1925474	1262	100	yes	406015	+
416	scaffold_2	1938763	1939181	418	63	yes	306991	-
417	scaffold_2	1940701	1941034	333	41	no	NA	NA
418	scaffold_2	1943862	1945522	1660	194	yes	384783	-
419	scaffold_2	1947847	1949171	1324	162	yes	289069	+
420	scaffold_2	1955157	1956176	1019	74	yes	64867	-
421	scaffold_2	1973376	1974448	1072	132	yes	307018	+
422	scaffold_2	1983526	1983931	405	42	yes	420779	+
423	scaffold_2	1991607	1992654	1047	115	yes	307028	+
424	scaffold_2	1997222	1998020	798	83	yes	420782	-
425	scaffold_2	2011007	2011033	26	6	no	NA	NA
426	scaffold_2	2011310	2011684	374	32	yes	387438	-
427	scaffold_2	2024582	2025616	1034	68	yes	307036	+
428	scaffold_2	2030454	2031797	1343	166	yes	65013	+
429	scaffold_2	2068477	2069703	1226	140	no	NA	NA
430	scaffold_2	2072387	2073860	1473	152	yes	65148	+
431	scaffold_2	2078583	2079768	1185	141	yes	307062,307064	-,+
432	scaffold_2	2080156	2081825	1669	167	yes	307062,307064	-,+
433	scaffold_2	2090677	2091577	900	77	yes	289094	+
434	scaffold_2	2091768	2091795	27	6	no	NA	NA
435	scaffold_2	2101238	2102603	1365	121	yes	307075	+
436	scaffold_2	2114722	2116618	1896	200	no	NA	NA
437	scaffold_2	2118267	2119254	987	99	no	NA	NA
438	scaffold_2	2119632	2119641	9	5	yes	364959	+
439	scaffold_2	2124960	2125924	964	138	yes	387455	+
440	scaffold_2	2129410	2130178	768	76	yes	307086	+
441	scaffold_2	2134658	2135764	1106	92	no	NA	NA
442	scaffold_2	2140440	2140691	251	22	yes	307089	-
443	scaffold_2	2143134	2144055	921	92	yes	387458	-
444	scaffold_2	2158352	2159741	1389	142	yes	307096	-
445	scaffold_2	2167532	2168512	980	74	yes	307104	+
446	scaffold_2	2175142	2176627	1485	174	yes	65552,65553	-,-
447	scaffold_2	2178732	2179679	947	118	yes	307112	-
448	scaffold_2	2181227	2182004	777	90	yes	307113	-
449	scaffold_2	2185937	2186260	323	36	yes	240174	+
450	scaffold_2	2191689	2193551	1862	183	yes	307118	-
451	scaffold_2	2199834	2200528	694	89	yes	307121	-
452	scaffold_2	2203563	2204063	500	41	yes	307125	+
453	scaffold_2	2207223	2207229	6	4	no	NA	NA
454	scaffold_2	2207404	2208055	651	63	yes	387471	-
455	scaffold_2	2213540	2214855	1315	135	yes	371528	-
456	scaffold_2	2215537	2215549	12	6	no	NA	NA
457	scaffold_2	2217487	2218577	1090	71	yes	289118	-
458	scaffold_2	2239268	2240493	1225	131	yes	387475	+
459	scaffold_2	2253289	2253728	439	33	yes	387478	+
460	scaffold_2	2261301	2262449	1148	67	yes	387479	-
461	scaffold_2	2280161	2280348	187	12	no	NA	NA
462	scaffold_2	2280556	2281595	1039	86	no	NA	NA
463	scaffold_2	2294185	2295037	852	118	yes	307152	+
464	scaffold_2	2304200	2305185	985	96	yes	307157	+
465	scaffold_2	2307500	2308466	966	103	yes	371535	+
466	scaffold_2	2315631	2316590	959	56	no	NA	NA
467	scaffold_2	2318685	2319680	995	109	yes	307159	-
468	scaffold_2	2343225	2344069	844	63	yes	307168	+
469	scaffold_2	2348231	2349443	1212	112	no	NA	NA
470	scaffold_2	2350126	2352559	2433	252	yes	65962	-
471	scaffold_2	2353253	2354233	980	89	yes	406104	+
472	scaffold_2	2357877	2359196	1319	143	yes	307178	+
473	scaffold_2	2364980	2366448	1468	192	yes	307180	+
474	scaffold_2	2378464	2379610	1146	132	yes	213324	-
475	scaffold_2	2379862	2380240	378	32	no	NA	NA
476	scaffold_2	2384430	2385595	1165	134	yes	307189	-
477	scaffold_2	2393741	2393766	25	4	no	NA	NA
478	scaffold_2	2403964	2405628	1664	215	yes	66096	-
479	scaffold_2	2408796	2410077	1281	121	yes	289147	+
480	scaffold_2	2414826	2415623	797	82	yes	307213	+
481	scaffold_2	2418612	2419916	1304	97	yes	406115	-
482	scaffold_2	2422100	2423132	1032	132	yes	307218	+
483	scaffold_2	2426195	2426510	315	50	yes	387504	-
484	scaffold_2	2427156	2428467	1311	150	yes	406119	+
485	scaffold_2	2435075	2435663	588	65	yes	307225	+
486	scaffold_2	2435773	2435850	77	8	no	NA	NA
487	scaffold_2	2435972	2435995	23	6	no	NA	NA
488	scaffold_2	2439206	2439933	727	70	yes	289155	-
489	scaffold_2	2441153	2441334	181	12	no	NA	NA
490	scaffold_2	2445147	2446474	1327	165	yes	66275	-
491	scaffold_2	2449047	2450238	1191	137	yes	66297	-
492	scaffold_2	2463325	2464635	1310	153	yes	307244	-
493	scaffold_2	2468375	2469366	991	116	yes	420862	-
494	scaffold_2	2470863	2471222	359	34	yes	307246	-
495	scaffold_2	2477479	2479164	1685	124	yes	420864	-
496	scaffold_2	2485837	2486108	271	36	no	NA	NA
497	scaffold_2	2488958	2489774	816	72	yes	307250	+
498	scaffold_2	2492236	2492917	681	63	yes	240220	+
499	scaffold_2	2502848	2503064	216	26	yes	307254	+
500	scaffold_2	2517262	2519051	1789	210	yes	387522	+
501	scaffold_2	2520362	2520429	67	15	no	NA	NA
502	scaffold_2	2522811	2523408	597	75	yes	420872	+
503	scaffold_2	2526460	2527510	1050	96	yes	307265	+
504	scaffold_2	2534233	2535543	1310	114	yes	227578	+
505	scaffold_2	2543137	2545654	2517	205	yes	307269	+
506	scaffold_2	2559599	2561281	1682	197	yes	371551	+
507	scaffold_2	2589162	2590561	1399	109	yes	387538	+
508	scaffold_2	2601494	2602326	832	82	yes	307325	+
509	scaffold_2	2619976	2621593	1617	118	yes	307327	+
510	scaffold_2	2627766	2628771	1005	112	no	NA	NA
511	scaffold_2	2629035	2630254	1219	106	no	NA	NA
512	scaffold_2	2638186	2638991	805	74	yes	307331	+
513	scaffold_2	2642726	2644203	1477	132	yes	387548	-
514	scaffold_2	2645401	2646532	1131	121	yes	420896	+
515	scaffold_2	2649998	2651111	1113	91	yes	307336	-
516	scaffold_2	2655824	2655848	24	6	no	NA	NA
517	scaffold_2	2656146	2656906	760	58	yes	420898	-
518	scaffold_2	2661234	2662528	1294	169	yes	307340	-
519	scaffold_2	2664461	2665804	1343	160	no	NA	NA
520	scaffold_2	2675003	2676298	1295	110	yes	307346	+
521	scaffold_2	2681458	2682177	719	40	yes	289208	-
522	scaffold_2	2686745	2687565	820	95	yes	307355	-
523	scaffold_2	2697679	2698562	883	92	yes	307359,307360	-,+
524	scaffold_2	2699088	2700004	916	113	yes	307360	+
525	scaffold_2	2700114	2700139	25	3	no	NA	NA
526	scaffold_2	2703947	2705291	1344	131	yes	289213	-
527	scaffold_2	2705941	2706954	1013	131	yes	420907	+
528	scaffold_2	2721420	2721948	528	46	yes	307369	-
529	scaffold_2	2726224	2727270	1046	141	no	NA	NA
530	scaffold_2	2729488	2730870	1382	193	yes	420912	-
531	scaffold_2	2731343	2731518	175	12	yes	420912	-
532	scaffold_2	2731649	2732457	808	86	no	NA	NA
533	scaffold_2	2765311	2765890	579	55	no	NA	NA
534	scaffold_2	2770209	2771733	1524	209	yes	307403	+
535	scaffold_2	2779082	2779989	907	72	no	NA	NA
536	scaffold_2	2788347	2788364	17	4	no	NA	NA
537	scaffold_2	2796602	2798084	1482	108	yes	67399	-
538	scaffold_2	2800859	2801210	351	40	yes	307415	+
539	scaffold_2	2801632	2801657	25	6	no	NA	NA
540	scaffold_2	2803240	2803752	512	47	yes	307416	+
541	scaffold_2	2806649	2807197	548	47	yes	406209	+
542	scaffold_2	2812967	2814236	1269	112	yes	307423	+
543	scaffold_2	2814423	2814439	16	4	no	NA	NA
544	scaffold_2	2817905	2818948	1043	120	yes	307426	-
545	scaffold_2	2824134	2824152	18	4	yes	307428	-
546	scaffold_2	2826218	2827673	1455	162	yes	307429	+
547	scaffold_2	2830720	2831867	1147	136	no	NA	NA
548	scaffold_2	2832436	2833740	1304	164	yes	307430	+
549	scaffold_2	2839425	2839446	21	6	yes	307431	+
550	scaffold_2	2839559	2839630	71	14	yes	307431	+
551	scaffold_2	2843449	2844586	1137	112	yes	289243	-
552	scaffold_2	2851057	2852339	1282	132	yes	406222	-
553	scaffold_2	2859996	2860985	989	108	yes	307444	-
554	scaffold_2	2862927	2863882	955	76	yes	307445	+
555	scaffold_2	2868744	2869605	861	98	yes	307447	+
556	scaffold_2	2881996	2882630	634	72	yes	384813	-
557	scaffold_2	2908679	2910177	1498	178	yes	364985	+
558	scaffold_2	2922654	2924096	1442	149	no	NA	NA
559	scaffold_2	2924761	2925437	676	83	no	NA	NA
560	scaffold_2	2928253	2929521	1268	135	yes	289255	+
561	scaffold_2	2940267	2941532	1265	165	yes	213106	+
562	scaffold_2	2947211	2949003	1792	223	yes	307494	-
563	scaffold_2	2953469	2954187	718	62	yes	307496	+
564	scaffold_2	2954303	2954367	64	14	no	NA	NA
565	scaffold_2	2956905	2957678	773	96	yes	67978	+
566	scaffold_2	2980998	2981054	56	13	no	NA	NA
567	scaffold_2	2983869	2985004	1135	135	yes	406248	-
568	scaffold_2	2985116	2985168	52	10	no	NA	NA
569	scaffold_2	2988675	2988685	10	4	no	NA	NA
570	scaffold_2	2989069	2989755	686	88	yes	307519	-
571	scaffold_2	2990140	2990468	328	36	yes	307519,307525	-,+
572	scaffold_2	2990845	2992094	1249	166	yes	307525	+
573	scaffold_2	2999312	3000385	1073	120	yes	68080	+
574	scaffold_2	3035674	3035706	32	9	no	NA	NA
575	scaffold_2	3035804	3035844	40	12	no	NA	NA
576	scaffold_2	3035952	3036166	214	30	no	NA	NA
577	scaffold_2	3054963	3055002	39	10	no	NA	NA
578	scaffold_2	3058640	3058659	19	6	no	NA	NA
579	scaffold_2	3063226	3064860	1634	149	yes	213427	+
580	scaffold_2	3068181	3069220	1039	113	yes	307554	-
581	scaffold_2	3072541	3073670	1129	140	yes	307558,387610	+,-
582	scaffold_2	3073836	3075007	1171	124	yes	307558,387610	+,-
583	scaffold_2	3080901	3081898	997	105	yes	213792	-
584	scaffold_2	3084259	3086335	2076	209	yes	387614	-
585	scaffold_2	3088235	3089160	925	100	yes	68290	+
586	scaffold_2	3103645	3104315	670	73	no	NA	NA
587	scaffold_2	3104857	3105528	671	50	yes	420970	+
588	scaffold_2	3111980	3113193	1213	106	yes	307576	-
589	scaffold_2	3119894	3120606	712	93	yes	387620	-
590	scaffold_2	3132606	3133620	1014	140	yes	387623	+
591	scaffold_2	3136207	3137464	1257	138	yes	68399	+
592	scaffold_2	3140165	3141533	1368	177	yes	307583	+
593	scaffold_2	3151083	3151564	481	54	no	NA	NA
594	scaffold_2	3156841	3157891	1050	138	no	NA	NA
595	scaffold_2	3158013	3158171	158	18	no	NA	NA
596	scaffold_2	3160893	3161350	457	41	no	NA	NA
597	scaffold_2	3164307	3164730	423	49	yes	307590	-
598	scaffold_2	3173590	3174731	1141	122	yes	289294	+
599	scaffold_2	3184000	3184848	848	81	yes	420983	-
600	scaffold_2	3192875	3193944	1069	101	yes	387633	-
601	scaffold_2	3199575	3200003	428	34	yes	387635	+
602	scaffold_2	3205392	3207664	2272	263	yes	307599	+
603	scaffold_2	3208378	3209806	1428	156	yes	406296	+
604	scaffold_2	3211433	3213358	1925	226	yes	68534	+
605	scaffold_2	3213627	3215015	1388	184	yes	289305	+
606	scaffold_2	3220273	3221891	1618	187	yes	420991	-
607	scaffold_2	3233043	3234373	1330	153	no	NA	NA
608	scaffold_2	3235654	3236719	1065	145	yes	68617	-
609	scaffold_2	3237098	3237114	16	3	no	NA	NA
610	scaffold_2	3238236	3239705	1469	166	yes	307615	+
611	scaffold_2	3253094	3254409	1315	131	yes	307619	+
612	scaffold_2	3258627	3259418	791	89	yes	307621	-
613	scaffold_2	3261792	3261838	46	8	no	NA	NA
614	scaffold_2	3262722	3264102	1380	190	yes	364999	-
615	scaffold_2	3265350	3266480	1130	121	yes	421002	+
616	scaffold_2	3268700	3268928	228	23	no	NA	NA
617	scaffold_2	3269024	3269865	841	109	yes	307627	-
618	scaffold_2	3270607	3272302	1695	226	yes	68760	+
619	scaffold_2	3277157	3278417	1260	94	yes	387654,406313	+,-
620	scaffold_2	3278659	3279430	771	93	yes	387654	+
621	scaffold_2	3281681	3282359	678	58	yes	307639	-
622	scaffold_2	3284650	3284682	32	7	no	NA	NA
623	scaffold_2	3284936	3284994	58	5	no	NA	NA
624	scaffold_2	3287981	3287998	17	6	no	NA	NA
625	scaffold_2	3292030	3292113	83	10	yes	387657	-
626	scaffold_2	3294542	3296387	1845	198	yes	289326,307646	-,-
627	scaffold_2	3299106	3300273	1167	126	yes	289328	+
628	scaffold_2	3308040	3308906	866	94	yes	406322	+
629	scaffold_2	3312419	3313648	1229	106	yes	307654,307655	-,+
630	scaffold_2	3317518	3318216	698	72	yes	307658	+
631	scaffold_2	3320930	3322055	1125	152	yes	387663,387664	-,+
632	scaffold_2	3330049	3330767	718	58	no	NA	NA
633	scaffold_2	3340764	3341716	952	108	yes	421018	-
634	scaffold_2	3357114	3358388	1274	100	yes	406332	-
635	scaffold_2	3363259	3364631	1372	162	no	NA	NA
636	scaffold_2	3379516	3380782	1266	131	yes	307679,371647	+,-
637	scaffold_2	3382982	3383694	712	94	yes	307684	+
638	scaffold_2	3386356	3387520	1164	105	yes	421026	+
639	scaffold_2	3391278	3392407	1129	113	yes	406338	+
640	scaffold_2	3394579	3395541	962	118	yes	421028	+
641	scaffold_2	3398747	3399840	1093	120	yes	387680	-
642	scaffold_2	3410423	3410437	14	4	no	NA	NA
643	scaffold_2	3410566	3412857	2291	205	yes	69164	-
644	scaffold_2	3416029	3417686	1657	237	yes	307699	+
645	scaffold_2	3432873	3433325	452	44	yes	69269	-
646	scaffold_2	3447589	3448179	590	38	yes	384837	+
647	scaffold_2	3451942	3453109	1167	96	yes	307727	-
648	scaffold_2	3455152	3456463	1311	159	yes	213660	+
649	scaffold_2	3461149	3462236	1087	110	yes	307732	-
650	scaffold_2	3473214	3474578	1364	154	yes	240434	+
651	scaffold_2	3480356	3482093	1737	153	yes	69436	-
652	scaffold_2	3482618	3483319	701	89	no	NA	NA
653	scaffold_28	11023	11253	230	17	yes	426630	-
654	scaffold_28	11357	11522	165	6	yes	426630	-
655	scaffold_28	22131	23437	1306	160	yes	408002	-
656	scaffold_28	29312	30606	1294	103	yes	322003	+
657	scaffold_28	38886	39680	794	115	yes	322007	-
658	scaffold_28	40754	41901	1147	159	yes	219841	+
659	scaffold_28	44408	45642	1234	125	yes	322011	+
660	scaffold_28	47594	48808	1214	110	yes	219834	+
661	scaffold_28	55433	56498	1065	100	yes	426636	-
662	scaffold_28	62806	64045	1239	138	yes	322020	+
663	scaffold_28	72956	73693	737	82	yes	322022	+
664	scaffold_28	75254	76094	840	101	yes	322024,426639	+,-
665	scaffold_28	96189	97215	1026	127	yes	426645	+
666	scaffold_28	105617	106187	570	66	yes	408024	-
667	scaffold_28	110502	111460	958	129	yes	426648	-
668	scaffold_28	113522	114988	1466	141	yes	408026	+
669	scaffold_28	117054	118347	1293	173	yes	322055	+
670	scaffold_28	143175	143749	574	50	yes	296023	+
671	scaffold_28	146404	147890	1486	187	yes	393282	-
672	scaffold_28	148252	149615	1363	155	yes	393282,296025	-,+
673	scaffold_28	155687	157256	1569	135	yes	365891	-
674	scaffold_28	160783	161667	884	101	no	NA	NA
675	scaffold_28	166933	168279	1346	133	yes	393286	-
676	scaffold_28	174793	175004	211	24	no	NA	NA
677	scaffold_28	234406	234431	25	4	no	NA	NA
678	scaffold_28	234528	235237	709	91	yes	393289	-
679	scaffold_28	244248	245148	900	109	no	NA	NA
680	scaffold_28	252386	253336	950	63	yes	89014	+
681	scaffold_28	258379	259331	952	102	yes	322078	-
682	scaffold_28	264260	265606	1346	131	yes	408048	-
683	scaffold_28	281969	282889	920	104	yes	89057	-
684	scaffold_28	287499	287554	55	11	no	NA	NA
685	scaffold_28	287692	288943	1251	99	yes	393296	-
686	scaffold_28	295217	295840	623	52	yes	426668	-
687	scaffold_28	299630	300580	950	98	yes	426669	-
688	scaffold_28	319058	320205	1147	116	yes	296046	-
689	scaffold_28	324020	324872	852	75	yes	393302	-
690	scaffold_28	330421	330441	20	4	no	NA	NA
691	scaffold_28	334055	335399	1344	132	yes	322108	+
692	scaffold_28	338311	339417	1106	118	yes	296050	-
693	scaffold_28	347138	347154	16	8	no	NA	NA
694	scaffold_28	347246	348365	1119	125	yes	322117	+
695	scaffold_28	348659	349531	872	103	yes	322117	+
696	scaffold_28	352020	353077	1057	115	yes	219823	+
697	scaffold_28	359752	360884	1132	128	yes	322125	-
698	scaffold_28	363171	364167	996	128	yes	408075	+
699	scaffold_28	369761	370398	637	50	yes	322133	-
700	scaffold_28	377081	378294	1213	137	yes	322136	-
701	scaffold_28	383016	383076	60	22	no	NA	NA
702	scaffold_28	412961	413929	968	120	yes	408086	+
703	scaffold_28	484610	485454	844	88	yes	322158	+
704	scaffold_28	500811	500866	55	13	no	NA	NA
705	scaffold_28	560812	561246	434	51	yes	393324	+
706	scaffold_28	567584	568684	1100	106	yes	393325	-
707	scaffold_28	586240	586268	28	8	yes	89548	-
708	scaffold_28	612064	612761	697	95	no	NA	NA
709	scaffold_28	612864	613663	799	76	yes	89592	-
710	scaffold_28	643689	643740	51	19	no	NA	NA
711	scaffold_28	643857	643910	53	9	no	NA	NA
712	scaffold_28	647559	647763	204	12	no	NA	NA
713	scaffold_28	647900	647963	63	12	no	NA	NA
714	scaffold_28	650328	651550	1222	90	yes	89626	+
715	scaffold_28	655975	657199	1224	88	yes	426715	+
716	scaffold_28	660807	663528	2721	264	no	NA	NA
717	scaffold_28	663822	665178	1356	97	no	NA	NA
718	scaffold_28	675898	676155	257	42	no	NA	NA
719	scaffold_28	677933	679267	1334	137	yes	89785	+
720	scaffold_28	681678	682807	1129	93	yes	296103	+
721	scaffold_28	684760	685999	1239	91	yes	426717	+
722	scaffold_28	688132	689391	1259	103	yes	393340	+
723	scaffold_28	693704	693853	149	14	no	NA	NA
724	scaffold_28	696587	697251	664	45	yes	89917	-
725	scaffold_28	698432	699662	1230	118	yes	408165	+
726	scaffold_28	725896	726343	447	56	yes	426719	+
727	scaffold_28	733753	733793	40	5	yes	393343	-
728	scaffold_28	754647	754871	224	15	yes	393344	+
729	scaffold_28	755007	755094	87	10	yes	393344	+
730	scaffold_28	785745	785813	68	20	no	NA	NA
731	scaffold_28	789876	789952	76	20	no	NA	NA
732	scaffold_28	790772	790840	68	16	no	NA	NA
733	scaffold_28	791658	791725	67	14	no	NA	NA
734	scaffold_28	792994	793070	76	18	no	NA	NA
735	scaffold_28	793860	793928	68	18	no	NA	NA
736	scaffold_28	794582	794641	59	14	no	NA	NA
737	scaffold_28	795439	795507	68	12	no	NA	NA
738	scaffold_28	796343	796402	59	13	no	NA	NA
739	scaffold_28	799042	799109	67	16	no	NA	NA
740	scaffold_28	800261	800281	20	8	no	NA	NA
741	scaffold_28	801230	801287	57	15	no	NA	NA
742	scaffold_28	802125	802200	75	18	no	NA	NA
743	scaffold_28	802949	803017	68	18	no	NA	NA
744	scaffold_28	803476	803544	68	16	no	NA	NA
745	scaffold_28	804369	804437	68	18	no	NA	NA
746	scaffold_28	805282	805349	67	14	no	NA	NA
747	scaffold_28	805680	805727	47	12	no	NA	NA
748	scaffold_28	806197	806217	20	8	no	NA	NA
749	scaffold_28	807992	808069	77	19	yes	408188	+
750	scaffold_28	808854	808933	79	15	yes	408189	+
751	scaffold_28	813743	813818	75	17	no	NA	NA
752	scaffold_28	814457	814525	68	16	no	NA	NA
753	scaffold_28	821682	821730	48	5	no	NA	NA
754	scaffold_28	822767	822803	36	7	yes	408193	-
755	scaffold_28	831829	831928	99	24	no	NA	NA
756	scaffold_28	832827	832894	67	14	no	NA	NA
757	scaffold_28	833717	833776	59	16	no	NA	NA
758	scaffold_28	880253	881638	1385	202	yes	393350	+
759	scaffold_28	886424	887749	1325	89	yes	373659,393354	+,+
760	scaffold_26	13679	14569	890	95	no	NA	NA
761	scaffold_26	61403	62566	1163	140	no	NA	NA
762	scaffold_26	67168	67182	14	6	no	NA	NA
763	scaffold_26	79152	80036	884	115	no	NA	NA
764	scaffold_26	82645	83696	1051	113	yes	321350	-
765	scaffold_26	93676	94951	1275	129	yes	426330	-
766	scaffold_26	107044	108301	1257	126	yes	321353	+
767	scaffold_26	131526	132322	796	119	no	NA	NA
768	scaffold_26	132821	132849	28	10	no	NA	NA
769	scaffold_26	135463	136462	999	102	yes	321364	+
770	scaffold_26	139975	139993	18	4	no	NA	NA
771	scaffold_26	140360	140384	24	5	yes	84378	-
772	scaffold_26	148472	149606	1134	110	yes	373088	+
773	scaffold_26	149720	149770	50	4	no	NA	NA
774	scaffold_26	156792	157077	285	18	yes	392958	-
775	scaffold_26	157161	157204	43	6	yes	392958	-
776	scaffold_26	166490	167097	607	56	yes	373098	-
777	scaffold_26	174798	175719	921	95	no	NA	NA
778	scaffold_26	192268	193254	986	93	yes	321393	-
779	scaffold_26	196025	197120	1095	121	yes	84458	-
780	scaffold_26	199563	200023	460	41	yes	321396	+
781	scaffold_26	215431	216293	862	75	yes	84475	+
782	scaffold_26	220623	221330	707	51	yes	245452	+
783	scaffold_26	224086	224756	670	54	yes	321404	+
784	scaffold_26	229821	230320	499	40	yes	233003	+
785	scaffold_26	239813	240146	333	28	yes	426356	+
786	scaffold_26	261015	262563	1548	139	no	NA	NA
787	scaffold_26	265757	266008	251	28	yes	245457	+
788	scaffold_26	278545	279520	975	97	yes	392974	-
789	scaffold_26	282642	283850	1208	108	no	NA	NA
790	scaffold_26	286004	286025	21	8	no	NA	NA
791	scaffold_26	286155	287239	1084	138	yes	426359	-
792	scaffold_26	288940	290463	1523	179	no	NA	NA
793	scaffold_26	297946	299055	1109	107	yes	426361	-
794	scaffold_26	301559	302778	1219	154	yes	426362	-
795	scaffold_26	306854	307851	997	87	yes	400563	-
796	scaffold_26	317068	318204	1136	126	yes	392981	-
797	scaffold_26	318504	318508	4	4	yes	392981	-
798	scaffold_26	325644	326159	515	19	yes	219692	+
799	scaffold_26	329253	329823	570	38	yes	321440	+
800	scaffold_26	344605	346284	1679	152	yes	373147	+
801	scaffold_26	347002	348232	1230	122	yes	321447	+
802	scaffold_26	351696	352810	1114	140	no	NA	NA
803	scaffold_26	354769	356104	1335	169	yes	373151	-
804	scaffold_26	358967	360581	1614	148	yes	321452	-
805	scaffold_26	367149	367968	819	96	yes	321456	+
806	scaffold_26	374129	374610	481	61	yes	321459	-
807	scaffold_26	376155	376517	362	48	no	NA	NA
808	scaffold_26	376656	376694	38	6	no	NA	NA
809	scaffold_26	376789	377094	305	37	yes	321460	-
810	scaffold_26	382337	382827	490	54	yes	321463	-
811	scaffold_26	394879	395992	1113	112	yes	321467	-
812	scaffold_26	398871	399533	662	72	yes	321468	-
813	scaffold_26	402812	404329	1517	149	yes	321470	-
814	scaffold_26	407957	409426	1469	190	yes	295701,426386	+,-
815	scaffold_26	409619	410041	422	53	yes	295701,426386	+,-
816	scaffold_26	410122	410425	303	37	yes	295701	+
817	scaffold_26	414327	414386	59	3	no	NA	NA
818	scaffold_26	414543	415550	1007	118	yes	426388	-
819	scaffold_26	416932	417848	916	86	yes	321479	-
820	scaffold_26	419259	420574	1315	154	yes	321480	+
821	scaffold_26	430836	432142	1306	99	yes	321483	+
822	scaffold_26	436647	437679	1032	129	no	NA	NA
823	scaffold_26	450759	451893	1134	151	no	NA	NA
824	scaffold_26	457890	459220	1330	163	yes	393019	+
825	scaffold_26	461680	462419	739	60	yes	233056	-
826	scaffold_26	463406	464721	1315	182	yes	321496	+
827	scaffold_26	467378	468381	1003	93	yes	321499	+
828	scaffold_26	468991	469572	581	53	yes	85046	+
829	scaffold_26	469685	469762	77	18	no	NA	NA
830	scaffold_26	477482	477739	257	42	yes	321502	-
831	scaffold_26	478536	479199	663	68	no	NA	NA
832	scaffold_26	479649	480951	1302	142	yes	400605	+
833	scaffold_26	483164	484622	1458	191	yes	295721	+
834	scaffold_26	488000	488010	10	3	no	NA	NA
835	scaffold_26	490980	492080	1100	130	yes	219689	-
836	scaffold_26	497513	498447	934	115	yes	321515	+
837	scaffold_26	500834	502633	1799	183	yes	85204	+
838	scaffold_26	503929	505050	1121	94	yes	219592	+
839	scaffold_26	507972	510782	2810	209	yes	321522,321523	-,+
840	scaffold_26	511025	512179	1154	148	yes	321522,321523	-,+
841	scaffold_26	513090	514204	1114	133	yes	321525	+
842	scaffold_26	527573	527615	42	8	no	NA	NA
843	scaffold_26	528278	529288	1010	106	yes	321533	+
844	scaffold_26	537307	538890	1583	191	yes	365861	+
845	scaffold_26	547492	548638	1146	109	yes	295739	+
846	scaffold_26	561030	561050	20	10	no	NA	NA
847	scaffold_26	561181	562512	1331	153	yes	426417	-
848	scaffold_26	562735	563483	748	115	yes	426417,321545	-,+
849	scaffold_26	566309	567676	1367	131	yes	321547	+
850	scaffold_26	576520	578040	1520	178	yes	321550,426421	-,+
851	scaffold_26	580919	581697	778	67	yes	426422	-
852	scaffold_26	582452	583523	1071	117	yes	233101	+
853	scaffold_26	586708	587813	1105	145	yes	321556,321559	-,+
854	scaffold_26	588030	589336	1306	119	yes	321556,321559	-,+
855	scaffold_26	594279	595710	1431	168	no	NA	NA
856	scaffold_26	607333	608197	864	127	yes	245546	-
857	scaffold_26	610964	610978	14	4	yes	321567	+
858	scaffold_26	611078	611713	635	55	yes	321567	+
859	scaffold_26	614990	615703	713	71	yes	321570	-
860	scaffold_26	616085	617551	1466	140	yes	321570,400637	-,+
861	scaffold_26	621310	622253	943	94	yes	321575	+
862	scaffold_26	631008	632029	1021	136	yes	321577	-
863	scaffold_26	632295	633725	1430	159	yes	321580	+
864	scaffold_26	641044	641070	26	5	no	NA	NA
865	scaffold_26	641225	642160	935	135	yes	393063	-
866	scaffold_26	645668	646881	1213	111	yes	321583	+
867	scaffold_26	647691	648631	940	133	yes	393065	+
868	scaffold_26	649650	650893	1243	129	yes	393066	+
869	scaffold_26	657043	657855	812	63	yes	321590	-
870	scaffold_26	664382	666061	1679	209	yes	393071	-
871	scaffold_26	671057	672053	996	142	yes	321595	-
872	scaffold_26	673185	674348	1163	132	yes	400651,400652	+,+
873	scaffold_26	685381	686250	869	116	yes	321603	-
874	scaffold_26	687219	688184	965	101	yes	219666	+
875	scaffold_26	690500	691339	839	83	yes	233127	-
876	scaffold_26	694583	695984	1401	149	yes	321607	-
877	scaffold_26	712941	714348	1407	185	yes	85873	+
878	scaffold_26	717561	718756	1195	150	yes	393083	+
879	scaffold_26	724944	726411	1467	175	yes	321617	-
880	scaffold_26	770045	771272	1227	126	yes	295786	-
881	scaffold_26	775432	776172	740	81	yes	321640	+
882	scaffold_26	784090	785386	1296	132	yes	393089	-
883	scaffold_26	796646	798950	2304	237	no	NA	NA
884	scaffold_26	800403	804428	4025	429	yes	321646,400678	+,+
885	scaffold_26	804766	806162	1396	182	yes	321646	+
886	scaffold_26	810617	810666	49	12	yes	321647	-
887	scaffold_26	814355	815172	817	72	yes	321648	+
888	scaffold_26	818347	820507	2160	169	yes	393095	-
889	scaffold_26	828849	829772	923	115	no	NA	NA
890	scaffold_26	831370	831621	251	29	yes	400684	+
891	scaffold_26	834796	835929	1133	150	yes	321655	-
892	scaffold_26	839316	839326	10	3	no	NA	NA
893	scaffold_26	839491	840677	1186	132	yes	373235	-
894	scaffold_26	850935	851893	958	125	yes	426470	-
895	scaffold_26	857420	858697	1277	145	yes	400689	+
896	scaffold_26	871500	872801	1301	137	yes	295801	-
897	scaffold_26	875241	876321	1080	91	yes	400692	+
898	scaffold_26	880325	881524	1199	116	yes	400693,426475	-,+
899	scaffold_26	881789	881799	10	4	no	NA	NA
900	scaffold_26	894042	895158	1116	124	yes	321679	+
901	scaffold_26	897172	898289	1117	137	yes	321680	+
902	scaffold_26	912205	913128	923	119	yes	373257	-
903	scaffold_26	920697	921619	922	65	yes	295812	+
904	scaffold_26	925707	926769	1062	141	yes	321688	+
905	scaffold_26	931284	932892	1608	150	yes	365873	-
906	scaffold_26	933653	934894	1241	126	yes	219517	+
907	scaffold_26	936370	936392	22	6	no	NA	NA
908	scaffold_26	937769	938892	1123	136	no	NA	NA
909	scaffold_26	945345	946710	1365	171	yes	400703	-
910	scaffold_26	947821	948437	616	25	yes	219495	+
911	scaffold_22	642	1172	530	61	no	NA	NA
912	scaffold_22	20695	20779	84	28	no	NA	NA
913	scaffold_22	23607	23677	70	22	no	NA	NA
914	scaffold_22	45867	46810	943	86	no	NA	NA
915	scaffold_22	51712	52562	850	84	yes	392214	+
916	scaffold_22	58895	59356	461	50	yes	319447	+
917	scaffold_22	60994	61792	798	112	yes	319449	+
918	scaffold_22	63624	64315	691	84	yes	319450	+
919	scaffold_22	87683	88864	1181	104	yes	392222	+
920	scaffold_22	103378	104535	1157	158	yes	407769	-
921	scaffold_22	109551	109564	13	4	no	NA	NA
922	scaffold_22	109691	111072	1381	138	yes	425600	-
923	scaffold_22	113725	114657	932	80	yes	425601	+
924	scaffold_22	126710	126801	91	22	yes	425602	+
925	scaffold_22	133460	135320	1860	229	yes	319466	-
926	scaffold_22	139262	140217	955	116	yes	319467	-
927	scaffold_22	141549	142655	1106	98	yes	407779	+
928	scaffold_22	145177	145183	6	4	no	NA	NA
929	scaffold_22	146915	147726	811	113	yes	74470,385518	+,-
930	scaffold_22	147946	149395	1449	175	yes	74470,385518,74448	+,-,+
931	scaffold_22	160915	162144	1229	174	yes	294808	-
932	scaffold_22	166509	167686	1177	122	yes	74498	-
933	scaffold_22	171964	172002	38	4	no	NA	NA
934	scaffold_22	172083	172890	807	76	yes	319489	-
935	scaffold_22	185622	187134	1512	119	yes	319499	-
936	scaffold_22	195488	196475	987	103	no	NA	NA
937	scaffold_22	203565	204473	908	66	yes	319505	+
938	scaffold_22	210367	212228	1861	251	yes	392241	-
939	scaffold_22	219283	219840	557	60	yes	425620	+
940	scaffold_22	236333	236405	72	12	no	NA	NA
941	scaffold_22	236502	237730	1228	170	no	NA	NA
942	scaffold_22	246378	247363	985	51	yes	74670	+
943	scaffold_22	264224	265729	1505	202	yes	319536	+
944	scaffold_22	269262	270577	1315	121	yes	319540	-
945	scaffold_22	274755	275500	745	82	yes	392248	-
946	scaffold_22	277935	278196	261	40	no	NA	NA
947	scaffold_22	278897	280706	1809	206	yes	407805	+
948	scaffold_22	284652	285246	594	64	yes	294827	+
949	scaffold_22	285400	285454	54	8	yes	294827	+
950	scaffold_22	292065	292417	352	14	yes	407808	+
951	scaffold_22	292507	293154	647	68	no	NA	NA
952	scaffold_22	295831	297024	1193	132	yes	425631	-
953	scaffold_22	300315	302900	2585	223	yes	319558,319560,392254	+,-,-
954	scaffold_22	303504	304763	1259	115	yes	319564	+
955	scaffold_22	308687	309999	1312	134	yes	319568	+
956	scaffold_22	311320	312726	1406	147	yes	319572	-
957	scaffold_22	313611	314807	1196	130	yes	319573	-
958	scaffold_22	318620	318743	123	28	yes	319575	-
959	scaffold_22	330691	332066	1375	129	yes	319584	+
960	scaffold_22	333850	335385	1535	155	yes	319587	+
961	scaffold_22	354686	355422	736	56	yes	294848	+
962	scaffold_22	360425	361216	791	86	no	NA	NA
963	scaffold_22	379433	380423	990	81	yes	74960	-
964	scaffold_22	386646	386902	256	20	yes	319599	-
965	scaffold_22	386999	387443	444	60	yes	319599	-
966	scaffold_22	388767	389630	863	94	yes	319602	+
967	scaffold_22	398118	399433	1315	153	yes	407838	-
968	scaffold_22	402196	403582	1386	148	no	NA	NA
969	scaffold_22	413213	414531	1318	141	yes	319615	-
970	scaffold_22	437804	438265	461	20	yes	319630	+
971	scaffold_22	438557	438566	9	4	yes	319630	+
972	scaffold_22	442182	443516	1334	158	yes	75144	+
973	scaffold_22	444981	446145	1164	134	yes	392285	-
974	scaffold_22	456279	456638	359	24	no	NA	NA
975	scaffold_22	459128	460250	1122	134	yes	392287	+
976	scaffold_22	460569	460578	9	4	no	NA	NA
977	scaffold_22	467367	467989	622	37	yes	407851	-
978	scaffold_22	472150	473443	1293	111	yes	425669	-
979	scaffold_22	479236	480445	1209	126	yes	319647	-
980	scaffold_22	482308	483585	1277	118	yes	319650	+
981	scaffold_22	490053	491305	1252	134	yes	75270	-
982	scaffold_22	492774	493671	897	77	no	NA	NA
983	scaffold_22	496784	497578	794	96	yes	319657	-
984	scaffold_22	501729	502510	781	75	yes	319658	+
985	scaffold_22	504348	505328	980	113	yes	319660,425679	-,+
986	scaffold_22	505653	506924	1271	122	yes	319660,425679	-,+
987	scaffold_22	508562	509272	710	66	yes	319663	+
988	scaffold_22	519987	521014	1027	102	yes	319669	+
989	scaffold_22	523205	523219	14	3	yes	425683	-
990	scaffold_22	523336	523365	29	8	yes	425683	-
991	scaffold_22	525166	525818	652	55	yes	319670	-
992	scaffold_22	535664	535886	222	24	yes	218918	-
993	scaffold_22	545658	546593	935	78	yes	385528	-
994	scaffold_22	551050	552440	1390	163	no	NA	NA
995	scaffold_22	567108	568092	984	112	yes	244865	+
996	scaffold_22	576501	577901	1400	165	yes	319686	-
997	scaffold_22	581621	582753	1132	160	yes	385529	+
998	scaffold_22	588045	588815	770	79	no	NA	NA
999	scaffold_22	596211	596947	736	71	yes	75470	-
1000	scaffold_22	599262	600087	825	109	yes	75487	+
1001	scaffold_22	610625	611352	727	56	yes	232371	-
1002	scaffold_22	614916	615718	802	73	yes	319702	+
1003	scaffold_22	617573	618690	1117	117	yes	319705	+
1004	scaffold_22	624727	626033	1306	169	yes	319707	-
1005	scaffold_22	638375	639444	1069	109	yes	319727	+
1006	scaffold_22	648659	649691	1032	104	yes	392327	+
1007	scaffold_22	654001	655473	1472	156	yes	407893	+
1008	scaffold_22	662497	662520	23	6	no	NA	NA
1009	scaffold_22	662626	663715	1089	103	yes	407894	-
1010	scaffold_22	676982	677223	241	40	yes	425709	+
1011	scaffold_22	677367	677561	194	23	no	NA	NA
1012	scaffold_22	697753	698591	838	107	yes	425711	+
1013	scaffold_22	706841	708629	1788	180	yes	319759	+
1014	scaffold_22	734135	734166	31	10	yes	425718	+
1015	scaffold_22	734301	734508	207	14	yes	425718	+
1016	scaffold_22	736002	737072	1070	89	yes	319779	+
1017	scaffold_22	742595	743817	1222	66	yes	294927,319787	-,+
1018	scaffold_22	757851	759429	1578	177	yes	407913	-
1019	scaffold_22	760725	761678	953	109	yes	75874	-
1020	scaffold_22	762209	763064	855	101	yes	75874,319791	-,+
1021	scaffold_22	764988	765019	31	5	no	NA	NA
1022	scaffold_22	765253	765620	367	57	yes	294930	+
1023	scaffold_22	772173	773517	1344	115	yes	407917	+
1024	scaffold_22	778481	779594	1113	94	yes	407919	+
1025	scaffold_22	782525	783848	1323	123	no	NA	NA
1026	scaffold_22	789182	790381	1199	116	yes	294936	-
1027	scaffold_22	791066	791949	883	95	yes	319806	+
1028	scaffold_22	803489	804662	1173	84	yes	407925	-
1029	scaffold_22	807240	808079	839	84	yes	319812	-
1030	scaffold_22	808521	809730	1209	141	yes	319812,425732	-,+
1031	scaffold_22	813184	814194	1010	131	yes	425733	-
1032	scaffold_22	816574	816605	31	8	no	NA	NA
1033	scaffold_22	816716	817915	1199	149	yes	319821	-
1034	scaffold_22	824517	825518	1001	126	yes	319823	+
1035	scaffold_22	826567	828075	1508	157	yes	294947	+
1036	scaffold_22	834951	836444	1493	136	yes	294949	-
1037	scaffold_22	839233	840209	976	132	yes	319829	-
1038	scaffold_22	842047	843238	1191	130	yes	319830	-
1039	scaffold_22	855010	855939	929	121	yes	319835	-
1040	scaffold_22	857505	858107	602	60	yes	76238	-
1041	scaffold_22	875090	876486	1396	185	yes	392369	-
1042	scaffold_22	879398	880510	1112	122	yes	425747	+
1043	scaffold_22	906215	907355	1140	127	yes	392374	-
1044	scaffold_22	907662	908883	1221	139	yes	392374	-
1045	scaffold_22	913228	914245	1017	121	yes	319871	-
1046	scaffold_22	924103	924997	894	124	yes	319879,319880	-,+
1047	scaffold_22	926285	927784	1499	137	yes	392379	+
1048	scaffold_22	944266	945129	863	112	yes	319889	+
1049	scaffold_22	946523	948041	1518	168	yes	319891	+
1050	scaffold_22	951186	952241	1055	125	yes	407963	+
1051	scaffold_22	964907	965223	316	38	no	NA	NA
1052	scaffold_22	974519	975834	1315	190	yes	425768	+
1053	scaffold_22	975926	976068	142	16	no	NA	NA
1054	scaffold_22	982977	984074	1097	105	yes	319906,392392	+,-
1055	scaffold_22	984238	986969	2731	225	yes	319906,392392,319908	+,-,-
1056	scaffold_22	990265	991206	941	86	yes	425772	+
1057	scaffold_22	992798	993984	1186	136	yes	319914	+
1058	scaffold_22	997182	998478	1296	123	yes	319917	+
1059	scaffold_22	1004665	1005760	1095	120	yes	392397	+
1060	scaffold_22	1009611	1010887	1276	173	yes	425776	-
1061	scaffold_22	1012142	1013548	1406	148	no	NA	NA
1062	scaffold_22	1018935	1020064	1129	147	yes	76714	+
1063	scaffold_22	1020207	1020231	24	8	no	NA	NA
1064	scaffold_22	1024837	1025576	739	74	yes	294995	+
1065	scaffold_22	1025734	1025861	127	7	no	NA	NA
1066	scaffold_22	1029280	1030311	1031	118	yes	294997	-
1067	scaffold_22	1030602	1031569	967	146	yes	294997,218994	-,+
1068	scaffold_22	1035721	1036358	637	63	yes	319946	+
1069	scaffold_22	1038825	1040222	1397	132	yes	385542	-
1070	scaffold_22	1045538	1045546	8	3	no	NA	NA
1071	scaffold_22	1045858	1046885	1027	38	yes	407983	-
1072	scaffold_22	1050019	1051185	1166	159	yes	319950	+
1073	scaffold_22	1059535	1060907	1372	183	yes	319955	+
1074	scaffold_22	1068583	1069657	1074	108	yes	76929	-
1075	scaffold_22	1072256	1073280	1024	110	yes	319960	-
1076	scaffold_22	1077066	1078561	1495	194	yes	319962	+
1077	scaffold_22	1082529	1084069	1540	166	yes	295010	+
1078	scaffold_22	1086616	1086634	18	4	no	NA	NA
1079	scaffold_22	1087886	1089724	1838	167	yes	232489	+
1080	scaffold_15	9631	10232	601	83	yes	316021	+
1081	scaffold_15	25504	25559	55	18	no	NA	NA
1082	scaffold_15	25817	26770	953	116	no	NA	NA
1083	scaffold_15	95029	97002	1973	145	no	NA	NA
1084	scaffold_15	97230	97495	265	9	yes	316034	+
1085	scaffold_15	107411	108378	967	86	no	NA	NA
1086	scaffold_15	110237	111564	1327	188	yes	316036	+
1087	scaffold_15	115085	115883	798	66	no	NA	NA
1088	scaffold_15	128203	128226	23	8	yes	316042	-
1089	scaffold_15	130908	130917	9	4	no	NA	NA
1090	scaffold_15	131597	132309	712	62	yes	418819	-
1091	scaffold_15	139301	140505	1204	93	yes	42140	-
1092	scaffold_15	142850	143556	706	32	yes	316049	+
1093	scaffold_15	144455	145542	1087	86	yes	424273	+
1094	scaffold_15	149540	150827	1287	139	yes	316053	-
1095	scaffold_15	153707	154824	1117	69	yes	42190	-
1096	scaffold_15	181790	181850	60	22	no	NA	NA
1097	scaffold_15	183619	184977	1358	194	yes	42233	+
1098	scaffold_15	198809	199413	604	66	yes	424279	-
1099	scaffold_15	201684	202719	1035	83	no	NA	NA
1100	scaffold_15	205073	205887	814	66	no	NA	NA
1101	scaffold_15	208694	209497	803	68	no	NA	NA
1102	scaffold_15	213098	213897	799	60	no	NA	NA
1103	scaffold_15	216284	217731	1447	110	yes	293228	-
1104	scaffold_15	227309	228631	1322	183	yes	424282	-
1105	scaffold_15	236729	238135	1406	97	no	NA	NA
1106	scaffold_15	238291	238301	10	4	no	NA	NA
1107	scaffold_15	246507	247756	1249	94	no	NA	NA
1108	scaffold_15	253827	254268	441	46	no	NA	NA
1109	scaffold_15	264840	265380	540	45	no	NA	NA
1110	scaffold_15	276906	276921	15	4	no	NA	NA
1111	scaffold_15	277019	277641	622	51	no	NA	NA
1112	scaffold_15	280486	280913	427	36	no	NA	NA
1113	scaffold_15	289097	289592	495	44	no	NA	NA
1114	scaffold_15	294841	294845	4	4	no	NA	NA
1115	scaffold_15	295304	295335	31	10	no	NA	NA
1116	scaffold_15	295429	295756	327	29	no	NA	NA
1117	scaffold_15	300996	301853	857	81	no	NA	NA
1118	scaffold_15	303812	303843	31	12	no	NA	NA
1119	scaffold_15	304139	304386	247	16	no	NA	NA
1120	scaffold_15	306077	306934	857	85	no	NA	NA
1121	scaffold_15	308859	308890	31	10	no	NA	NA
1122	scaffold_15	309219	309320	101	14	no	NA	NA
1123	scaffold_15	311122	311747	625	52	no	NA	NA
1124	scaffold_15	313896	313927	31	8	no	NA	NA
1125	scaffold_15	317023	318366	1343	153	yes	42678	-
1126	scaffold_15	322562	323579	1017	99	yes	316106	-
1127	scaffold_15	338928	340739	1811	182	yes	293236	+
1128	scaffold_15	353469	354280	811	92	yes	42725	+
1129	scaffold_15	359388	360162	774	62	no	NA	NA
1130	scaffold_15	374713	374825	112	3	yes	418875	+
1131	scaffold_15	406199	406752	553	66	yes	243513	+
1132	scaffold_15	407638	408356	718	96	no	NA	NA
1133	scaffold_15	410103	410764	661	60	yes	316131	-
1134	scaffold_15	415005	416269	1264	143	no	NA	NA
1135	scaffold_15	419425	420142	717	70	yes	42826	-
1136	scaffold_15	426648	426674	26	4	yes	42839	-
1137	scaffold_15	426884	428252	1368	114	yes	42839	-
1138	scaffold_15	439833	441043	1210	156	yes	316146	+
1139	scaffold_15	443396	443405	9	4	no	NA	NA
1140	scaffold_15	444801	445677	876	73	yes	316153	+
1141	scaffold_15	453004	454406	1402	160	yes	424312	+
1142	scaffold_15	457652	458937	1285	131	yes	217300	+
1143	scaffold_15	463380	464484	1104	119	yes	418893	+
1144	scaffold_15	468293	469284	991	107	yes	316169	+
1145	scaffold_15	472974	473993	1019	90	yes	316173	-
1146	scaffold_15	510200	511360	1160	150	yes	390959	-
1147	scaffold_15	518625	519861	1236	144	yes	217317	+
1148	scaffold_15	520007	520014	7	4	yes	217317	+
1149	scaffold_15	525111	526073	962	135	yes	316194,424326	+,-
1150	scaffold_15	526513	528037	1524	199	yes	316194	+
1151	scaffold_15	535968	537277	1309	136	yes	316198,316200	-,+
1152	scaffold_15	537453	538549	1096	151	yes	316198,316200	-,+
1153	scaffold_15	541184	541194	10	4	no	NA	NA
1154	scaffold_15	541370	542349	979	123	yes	316203	-
1155	scaffold_15	546998	548129	1131	116	yes	43217,43243	-,-
1156	scaffold_15	549145	550488	1343	147	yes	217456	+
1157	scaffold_15	554265	555436	1171	127	yes	43277	-
1158	scaffold_15	556865	558035	1170	159	yes	316211	+
1159	scaffold_15	570125	571360	1235	66	yes	418917	+
1160	scaffold_15	586239	587075	836	107	yes	293283	+
1161	scaffold_15	598177	599267	1090	129	yes	217443	-
1162	scaffold_15	599765	600370	605	46	yes	316220	+
1163	scaffold_15	604999	606472	1473	172	yes	316223	-
1164	scaffold_15	614657	614684	27	7	no	NA	NA
1165	scaffold_15	615478	616611	1133	134	yes	424342	+
1166	scaffold_15	620555	620564	9	4	no	NA	NA
1167	scaffold_15	625319	626791	1472	127	no	NA	NA
1168	scaffold_15	658679	659780	1101	107	yes	424346	-
1169	scaffold_15	660246	660308	62	14	no	NA	NA
1170	scaffold_15	663289	664553	1264	137	yes	316256	-
1171	scaffold_15	670218	670733	515	34	yes	316259	+
1172	scaffold_15	693301	694365	1064	136	yes	418941	-
1173	scaffold_15	694938	696108	1170	168	yes	418942	+
1174	scaffold_15	696299	696303	4	4	no	NA	NA
1175	scaffold_15	707986	709040	1054	72	yes	293308	+
1176	scaffold_15	714051	715353	1302	100	yes	243573	+
1177	scaffold_15	715787	715933	146	5	yes	243573	+
1178	scaffold_15	723495	724234	739	67	yes	316285	+
1179	scaffold_15	727152	728362	1210	157	yes	424359	+
1180	scaffold_15	771244	773072	1828	178	yes	316302	+
1181	scaffold_15	777834	778349	515	53	yes	391000	+
1182	scaffold_15	782728	783127	399	42	yes	316305	+
1183	scaffold_15	836563	837143	580	53	yes	365559	+
1184	scaffold_15	847798	847844	46	12	no	NA	NA
1185	scaffold_15	848070	848122	52	12	no	NA	NA
1186	scaffold_15	848338	848412	74	14	no	NA	NA
1187	scaffold_15	848508	848571	63	11	no	NA	NA
1188	scaffold_15	848689	848855	166	13	no	NA	NA
1189	scaffold_15	849029	849042	13	6	no	NA	NA
1190	scaffold_15	849598	850912	1314	153	no	NA	NA
1191	scaffold_15	855794	856338	544	65	no	NA	NA
1192	scaffold_15	874736	876247	1511	167	yes	316325	-
1193	scaffold_15	883136	884147	1011	86	no	NA	NA
1194	scaffold_15	897547	898679	1132	115	yes	316328	+
1195	scaffold_15	909913	910580	667	90	yes	316332	-
1196	scaffold_15	911043	912040	997	84	yes	316333	+
1197	scaffold_15	913021	914657	1636	229	yes	316335	+
1198	scaffold_15	917346	918466	1120	106	yes	43971	-
1199	scaffold_15	922629	924014	1385	153	yes	316341	+
1200	scaffold_15	925990	926637	647	81	no	NA	NA
1201	scaffold_15	941947	943120	1173	103	yes	316350,424384	+,-
1202	scaffold_15	943340	944454	1114	119	yes	316350,424384	+,-
1203	scaffold_15	950577	951490	913	132	yes	316353	+
1204	scaffold_15	957209	958042	833	98	yes	316355	+
1205	scaffold_15	960084	961532	1448	141	yes	316356	-
1206	scaffold_15	961805	962575	770	88	yes	316356	-
1207	scaffold_15	962688	962725	37	12	no	NA	NA
1208	scaffold_15	962856	962872	16	4	no	NA	NA
1209	scaffold_15	966327	967119	792	73	yes	316367	+
1210	scaffold_15	973549	975524	1975	214	yes	424393	+
1211	scaffold_15	985123	986043	920	98	yes	316375	-
1212	scaffold_15	986666	988379	1713	169	yes	316375,44198	-,-
1213	scaffold_15	992673	993925	1252	152	yes	44152,316381	-,-
1214	scaffold_15	997226	998567	1341	175	yes	316389	-
1215	scaffold_15	1008522	1009803	1281	163	yes	293362,316398	-,+
1216	scaffold_15	1009978	1011112	1134	112	yes	293362,316398	-,+
1217	scaffold_15	1018548	1019447	899	134	yes	316400,424403	-,+
1218	scaffold_15	1035151	1036633	1482	181	yes	293368	-
1219	scaffold_15	1038261	1038349	88	8	no	NA	NA
1220	scaffold_15	1038456	1039248	792	86	yes	316410	-
1221	scaffold_15	1040612	1042038	1426	167	yes	44341	+
1222	scaffold_15	1055915	1056640	725	99	yes	419017	+
1223	scaffold_15	1060825	1061986	1161	119	yes	424408	-
1224	scaffold_15	1064535	1065949	1414	110	yes	243631	+
1225	scaffold_15	1072632	1073712	1080	137	yes	316426	-
1226	scaffold_15	1077299	1078021	722	81	yes	44471	-
1227	scaffold_15	1079742	1080329	587	72	yes	419023	-
1228	scaffold_15	1080743	1082159	1416	157	yes	419023,419024	-,+
1229	scaffold_15	1086408	1087509	1101	106	yes	316434	+
1230	scaffold_15	1090479	1092053	1574	169	yes	316435	+
1231	scaffold_15	1104978	1106133	1155	70	yes	44567	+
1232	scaffold_15	1115603	1116725	1122	115	yes	44582	-
1233	scaffold_15	1131164	1131169	5	4	no	NA	NA
1234	scaffold_15	1131292	1132696	1404	157	yes	316448	-
1235	scaffold_15	1135760	1136752	992	98	yes	316451	+
1236	scaffold_15	1142854	1144482	1628	178	yes	293396	+
1237	scaffold_15	1151668	1152255	587	56	yes	316458	-
1238	scaffold_15	1158134	1159071	937	130	no	NA	NA
1239	scaffold_15	1162346	1163621	1275	133	yes	316463	+
1240	scaffold_15	1167427	1168538	1111	127	yes	44794	+
1241	scaffold_15	1189640	1190894	1254	146	yes	419046	+
1242	scaffold_15	1199111	1199901	790	78	yes	419047	+
1243	scaffold_15	1226081	1227408	1327	162	yes	316484	+
1244	scaffold_15	1245767	1245791	24	7	yes	316487	+
1245	scaffold_19	8025	9336	1311	156	yes	318069	+
1246	scaffold_19	13336	14288	952	128	yes	401286	+
1247	scaffold_19	17207	18660	1453	167	yes	401288	+
1248	scaffold_19	23902	25115	1213	183	yes	318078	-
1249	scaffold_19	26176	26341	165	12	yes	318081	-
1250	scaffold_19	32388	33451	1063	168	yes	318086	+
1251	scaffold_19	34336	34354	18	6	no	NA	NA
1252	scaffold_19	34578	35172	594	62	no	NA	NA
1253	scaffold_19	35329	35392	63	12	no	NA	NA
1254	scaffold_19	40615	41612	997	89	yes	294113	+
1255	scaffold_19	49866	50206	340	23	yes	318093	+
1256	scaffold_19	51462	51503	41	12	no	NA	NA
1257	scaffold_19	53940	54007	67	14	no	NA	NA
1258	scaffold_19	54456	55554	1098	158	yes	318094	-
1259	scaffold_19	60956	62231	1275	146	yes	425017	-
1260	scaffold_19	63231	63666	435	48	no	NA	NA
1261	scaffold_19	84353	85531	1178	78	no	NA	NA
1262	scaffold_19	94370	96548	2178	177	yes	318108	-
1263	scaffold_19	96995	97003	8	4	yes	318108	-
1264	scaffold_19	97251	98409	1158	117	yes	318110	+
1265	scaffold_19	101057	102232	1175	137	yes	318111	+
1266	scaffold_19	107153	107178	25	8	no	NA	NA
1267	scaffold_19	107305	107974	669	63	no	NA	NA
1268	scaffold_19	112215	112469	254	19	no	NA	NA
1269	scaffold_19	112563	113008	445	34	no	NA	NA
1270	scaffold_19	116373	117788	1415	162	yes	425027	-
1271	scaffold_19	131636	131643	7	4	yes	425030	-
1272	scaffold_19	134154	135462	1308	163	yes	318129	-
1273	scaffold_19	137902	137910	8	4	yes	318131	+
1274	scaffold_19	146726	148234	1508	180	yes	318134,391670	+,-
1275	scaffold_19	156996	158316	1320	140	yes	54514	-
1276	scaffold_19	160440	160449	9	4	no	NA	NA
1277	scaffold_19	161536	162470	934	97	yes	401316	-
1278	scaffold_19	185851	186814	963	151	no	NA	NA
1279	scaffold_19	202678	203562	884	60	yes	318197	-
1280	scaffold_19	204577	204589	12	6	no	NA	NA
1281	scaffold_19	218750	220241	1491	133	yes	54709	+
1282	scaffold_19	223005	224500	1495	150	yes	401325	+
1283	scaffold_19	229081	230564	1483	162	yes	318208	+
1284	scaffold_19	233191	234414	1223	121	yes	425044	+
1285	scaffold_19	234571	234617	46	8	no	NA	NA
1286	scaffold_19	237416	238798	1382	132	yes	318216	-
1287	scaffold_19	239711	241222	1511	213	yes	318217	+
1288	scaffold_19	247835	248742	907	95	yes	401330	+
1289	scaffold_19	254994	255000	6	3	no	NA	NA
1290	scaffold_19	259532	260621	1089	110	yes	294153	-
1291	scaffold_19	264259	265357	1098	120	yes	318228	-
1292	scaffold_19	266180	267686	1506	222	yes	318231	+
1293	scaffold_19	267899	267906	7	4	no	NA	NA
1294	scaffold_19	284503	285041	538	43	yes	318235	-
1295	scaffold_19	291562	292446	884	107	yes	318240	-
1296	scaffold_19	294801	295828	1027	86	no	NA	NA
1297	scaffold_19	300623	300671	48	12	no	NA	NA
1298	scaffold_19	301145	302304	1159	126	yes	294160	+
1299	scaffold_19	304932	305946	1014	120	yes	318247	+
1300	scaffold_19	306134	306171	37	6	no	NA	NA
1301	scaffold_19	306614	306625	11	5	no	NA	NA
1302	scaffold_19	318846	319236	390	43	no	NA	NA
1303	scaffold_19	320264	321832	1568	110	yes	318259	-
1304	scaffold_19	323341	324109	768	82	yes	318263	+
1305	scaffold_19	330506	331763	1257	131	yes	55087	-
1306	scaffold_19	336049	337396	1347	145	yes	425062	-
1307	scaffold_19	343259	343308	49	8	yes	218265	-
1308	scaffold_19	350716	351660	944	91	yes	425065	-
1309	scaffold_19	351771	351968	197	22	yes	425065	-
1310	scaffold_19	355011	355937	926	78	yes	391703	-
1311	scaffold_19	356030	356268	238	25	yes	391703	-
1312	scaffold_19	359600	360742	1142	88	no	NA	NA
1313	scaffold_19	360842	360878	36	10	yes	425067	-
1314	scaffold_19	369288	370512	1224	85	yes	401357	-
1315	scaffold_19	378274	379819	1545	155	yes	318277,318280	-,+
1316	scaffold_19	380192	380438	246	42	yes	318280	+
1317	scaffold_19	381801	382776	975	118	yes	55162	+
1318	scaffold_19	389113	389126	13	4	no	NA	NA
1319	scaffold_19	389430	390365	935	118	yes	318285	+
1320	scaffold_19	396053	397272	1219	134	yes	318290	-
1321	scaffold_19	406499	407248	749	60	yes	294180	+
1322	scaffold_19	413333	414271	938	116	yes	294181	-
1323	scaffold_19	416586	416597	11	6	no	NA	NA
1324	scaffold_19	416721	417846	1125	148	yes	391713	-
1325	scaffold_19	419105	420307	1202	149	yes	318299	+
1326	scaffold_19	426900	427724	824	72	yes	318301	+
1327	scaffold_19	432032	432722	690	81	yes	318303	-
1328	scaffold_19	437634	439148	1514	195	yes	365672	+
1329	scaffold_19	442612	443247	635	71	yes	318306	-
1330	scaffold_19	445565	446663	1098	153	yes	425081	-
1331	scaffold_19	447378	448081	703	54	no	NA	NA
1332	scaffold_19	460183	461631	1448	108	yes	365673	-
1333	scaffold_19	463613	463638	25	7	no	NA	NA
1334	scaffold_19	464998	466773	1775	175	yes	318321	-
1335	scaffold_19	470533	470728	195	10	no	NA	NA
1336	scaffold_19	472594	473534	940	118	yes	318324	-
1337	scaffold_19	474964	475794	830	131	yes	391724	-
1338	scaffold_19	477723	478667	944	77	yes	294197	+
1339	scaffold_19	483459	484665	1206	130	yes	55413	-
1340	scaffold_19	490282	493351	3069	260	yes	318335,365675	-,+
1341	scaffold_19	493577	494564	987	103	yes	318335	-
1342	scaffold_19	501191	502596	1405	159	yes	294203	-
1343	scaffold_19	504994	505583	589	47	yes	318339	+
1344	scaffold_19	529405	529427	22	8	yes	244320	-
1345	scaffold_19	533808	534046	238	36	no	NA	NA
1346	scaffold_19	536672	537542	870	99	yes	318354	+
1347	scaffold_19	555779	557081	1302	133	yes	318365	-
1348	scaffold_19	559969	560476	507	56	yes	318371	-
1349	scaffold_19	564740	565425	685	82	yes	401401	+
1350	scaffold_19	570636	571951	1315	147	yes	294216	-
1351	scaffold_19	574679	575595	916	99	yes	244331	+
1352	scaffold_19	580114	581893	1779	236	yes	371112	+
1353	scaffold_19	591163	592270	1107	148	yes	318386	+
1354	scaffold_19	596743	597547	804	102	yes	318394,318395	-,+
1355	scaffold_19	597745	598902	1157	112	yes	318394,318395	-,+
1356	scaffold_19	610854	612027	1173	96	yes	425111	-
1357	scaffold_19	614886	615860	974	114	yes	401410	-
1358	scaffold_19	622213	623728	1515	145	yes	401411	+
1359	scaffold_19	625505	627047	1542	172	yes	318405	+
1360	scaffold_19	633233	633252	19	4	no	NA	NA
1361	scaffold_19	633403	634439	1036	116	yes	318410,401414	+,-
1362	scaffold_19	634882	635834	952	102	yes	318410	+
1363	scaffold_19	638088	639513	1425	152	yes	318411	+
1364	scaffold_19	645215	645650	435	44	yes	55831	-
1365	scaffold_19	650762	651361	599	72	yes	318417	+
1366	scaffold_19	651452	651699	247	23	no	NA	NA
1367	scaffold_19	658817	660206	1389	148	yes	318421	+
1368	scaffold_19	662627	663763	1136	99	yes	318422	+
1369	scaffold_19	663943	663957	14	4	no	NA	NA
1370	scaffold_19	667655	668507	852	100	yes	55907	+
1371	scaffold_19	672053	672097	44	10	no	NA	NA
1372	scaffold_19	672313	672579	266	28	no	NA	NA
1373	scaffold_19	672774	672817	43	12	no	NA	NA
1374	scaffold_19	675129	675311	182	25	yes	244355	+
1375	scaffold_19	681061	682676	1615	163	yes	218258	+
1376	scaffold_19	713152	713896	744	84	yes	425130	+
1377	scaffold_19	721865	722769	904	118	no	NA	NA
1378	scaffold_19	726223	726632	409	34	yes	318455,425133	+,-
1379	scaffold_19	727085	728222	1137	156	yes	318455,425133	+,-
1380	scaffold_19	734493	735901	1408	187	yes	318457	-
1381	scaffold_19	738644	739899	1255	74	yes	318460	+
1382	scaffold_19	740051	740092	41	5	no	NA	NA
1383	scaffold_19	748780	749921	1141	155	yes	318463	+
1384	scaffold_19	754520	755402	882	95	yes	401443	+
1385	scaffold_19	770233	771744	1511	93	no	NA	NA
1386	scaffold_19	771997	773359	1362	131	yes	401446	+
1387	scaffold_19	782071	783271	1200	90	yes	425143	-
1388	scaffold_19	787180	788617	1437	186	yes	318482	+
1389	scaffold_19	788919	789878	959	104	yes	318482	+
1390	scaffold_19	793512	794675	1163	107	yes	318486	-
1391	scaffold_19	800104	801849	1745	223	yes	318487	-
1392	scaffold_19	807149	807624	475	42	yes	365684	+
1393	scaffold_19	818213	819221	1008	110	yes	318497	+
1394	scaffold_19	829389	829435	46	8	yes	318503	-
1395	scaffold_19	834958	835808	850	114	yes	318505	+
1396	scaffold_19	842404	844072	1668	135	yes	425152	+
1397	scaffold_19	853737	856051	2314	254	yes	318513	+
1398	scaffold_19	863489	865049	1560	126	yes	294272	-
1399	scaffold_19	869608	870676	1068	141	yes	244385	-
1400	scaffold_19	879246	880451	1205	138	yes	56376	-
1401	scaffold_19	882716	882737	21	5	no	NA	NA
1402	scaffold_19	882829	884023	1194	114	yes	391797	-
1403	scaffold_19	885764	887262	1498	154	yes	218180	+
1404	scaffold_19	891360	892444	1084	166	yes	391799	+
1405	scaffold_19	897077	898773	1696	148	yes	318531	+
1406	scaffold_19	900411	901378	967	116	yes	318537	+
1407	scaffold_19	915921	917302	1381	90	yes	425165	+
1408	scaffold_19	926214	927299	1085	97	yes	294286	+
1409	scaffold_19	931914	932969	1055	124	yes	294287	-
1410	scaffold_19	934715	935678	963	126	yes	318545	+
1411	scaffold_19	936953	937568	615	77	yes	425169	+
1412	scaffold_19	939668	940814	1146	111	yes	318546	+
1413	scaffold_19	943222	944249	1027	90	yes	294291	+
1414	scaffold_19	953968	955206	1238	135	yes	318552	+
1415	scaffold_19	960205	961278	1073	148	yes	318557	-
1416	scaffold_19	984806	984835	29	5	no	NA	NA
1417	scaffold_19	984997	985214	217	17	no	NA	NA
1418	scaffold_19	985498	985795	297	30	yes	56740	-
1419	scaffold_19	991256	991841	585	68	no	NA	NA
1420	scaffold_19	991973	991979	6	4	yes	318561	-
1421	scaffold_19	992270	992459	189	20	yes	318561	-
1422	scaffold_19	1103524	1103584	60	22	no	NA	NA
1423	scaffold_19	1125519	1126459	940	118	no	NA	NA
1424	scaffold_19	1126731	1126786	55	18	no	NA	NA
1425	scaffold_10	2709	3453	744	84	no	NA	NA
1426	scaffold_10	10243	10415	172	25	no	NA	NA
1427	scaffold_10	10516	10551	35	8	no	NA	NA
1428	scaffold_10	11000	11051	51	13	no	NA	NA
1429	scaffold_10	16285	17498	1213	118	yes	313010	-
1430	scaffold_10	27264	27477	213	33	no	NA	NA
1431	scaffold_10	36980	38519	1539	108	yes	313019	-
1432	scaffold_10	39627	41104	1477	173	yes	15439	+
1433	scaffold_10	43980	45137	1157	130	yes	313023	+
1434	scaffold_10	46536	47786	1250	145	yes	313027	+
1435	scaffold_10	52131	52840	709	83	yes	313029	-
1436	scaffold_10	54228	55246	1018	119	yes	229797	+
1437	scaffold_10	63734	64723	989	133	yes	423126	-
1438	scaffold_10	68800	70084	1284	105	yes	389798	-
1439	scaffold_10	70959	71949	990	124	yes	389799	-
1440	scaffold_10	74334	75408	1074	107	yes	423128	+
1441	scaffold_10	77611	78802	1191	118	yes	313057	-
1442	scaffold_10	83872	85133	1261	134	yes	313063	-
1443	scaffold_10	85519	86167	648	77	yes	313063	-
1444	scaffold_10	86508	87309	801	102	yes	313066,389803	+,-
1445	scaffold_10	87501	88655	1154	130	yes	313066,389803	+,-
1446	scaffold_10	99847	99866	19	3	no	NA	NA
1447	scaffold_10	99988	101942	1954	183	yes	407143	-
1448	scaffold_10	109896	111093	1197	139	yes	313073	-
1449	scaffold_10	113927	114942	1015	83	yes	207007	+
1450	scaffold_10	129959	130988	1029	153	yes	423136	-
1451	scaffold_10	141343	142934	1591	183	yes	313084	-
1452	scaffold_10	152154	152178	24	6	no	NA	NA
1453	scaffold_10	152498	152515	17	4	no	NA	NA
1454	scaffold_10	152815	154179	1364	167	yes	313088	-
1455	scaffold_10	156104	156854	750	82	no	NA	NA
1456	scaffold_10	159034	160178	1144	93	yes	16173	-
1457	scaffold_10	162178	162194	16	3	no	NA	NA
1458	scaffold_10	172175	173056	881	67	yes	313094	+
1459	scaffold_10	182163	182175	12	4	no	NA	NA
1460	scaffold_10	182498	182685	187	20	yes	291907	-
1461	scaffold_10	182778	183592	814	74	yes	291907	-
1462	scaffold_10	196617	197877	1260	171	yes	313099	+
1463	scaffold_10	202284	203179	895	92	no	NA	NA
1464	scaffold_10	211383	213044	1661	188	yes	291912	-
1465	scaffold_10	214524	215521	997	121	yes	423149	+
1466	scaffold_10	222344	223392	1048	108	yes	313114,313116	-,+
1467	scaffold_10	223603	224671	1068	150	yes	313114,313116	-,+
1468	scaffold_10	231026	232356	1330	122	yes	389825	-
1469	scaffold_10	234389	234398	9	4	no	NA	NA
1470	scaffold_10	238670	239844	1174	202	no	NA	NA
1471	scaffold_10	247146	247776	630	56	yes	389826	+
1472	scaffold_10	250572	252195	1623	229	no	NA	NA
1473	scaffold_10	252363	252411	48	6	no	NA	NA
1474	scaffold_10	269175	270153	978	143	no	NA	NA
1475	scaffold_10	279217	280308	1091	112	no	NA	NA
1476	scaffold_10	280846	281649	803	57	no	NA	NA
1477	scaffold_10	288241	289239	998	102	yes	389829	-
1478	scaffold_10	294212	295261	1049	145	yes	313138	-
1479	scaffold_10	298152	299553	1401	123	yes	407179	+
1480	scaffold_10	303968	306636	2668	293	yes	16495	-
1481	scaffold_10	310788	311856	1068	51	yes	313147	+
1482	scaffold_10	315449	315653	204	14	no	NA	NA
1483	scaffold_10	315847	317301	1454	158	yes	313149	-
1484	scaffold_10	318363	319435	1072	108	yes	291928	+
1485	scaffold_10	322322	323188	866	56	yes	313155,313156	-,+
1486	scaffold_10	323658	325253	1595	173	yes	313155,313156,16573	-,+,+
1487	scaffold_10	325535	326628	1093	110	yes	16573,16574	+,+
1488	scaffold_10	326886	328176	1290	126	yes	16574	+
1489	scaffold_10	335779	336571	792	81	yes	423168	-
1490	scaffold_10	339043	339079	36	10	yes	242418	+
1491	scaffold_10	344775	346025	1250	132	yes	291937	-
1492	scaffold_10	346827	347854	1027	88	yes	313168	+
1493	scaffold_10	349166	349936	770	98	yes	313171	+
1494	scaffold_10	350185	351021	836	66	no	NA	NA
1495	scaffold_10	357908	359590	1682	198	yes	291939	-
1496	scaffold_10	364852	366300	1448	143	yes	313175	+
1497	scaffold_10	366463	366513	50	8	no	NA	NA
1498	scaffold_10	376657	377750	1093	147	yes	389846	-
1499	scaffold_10	383551	384715	1164	122	yes	242421	-
1500	scaffold_10	384989	385653	664	75	no	NA	NA
1501	scaffold_10	386079	386095	16	4	no	NA	NA
1502	scaffold_10	387767	388990	1223	172	yes	313185	-
1503	scaffold_10	389472	390795	1323	140	yes	313185,313186	-,+
1504	scaffold_10	393967	395053	1086	112	yes	313189	-
1505	scaffold_10	401988	403461	1473	166	yes	16877	+
1506	scaffold_10	405626	406612	986	114	yes	313196	+
1507	scaffold_10	409450	410924	1474	142	yes	16885	+
1508	scaffold_10	415120	416360	1240	133	yes	229853	+
1509	scaffold_10	423527	424269	742	62	yes	242436	-
1510	scaffold_10	431361	432724	1363	135	yes	423186	-
1511	scaffold_10	436271	436276	5	4	no	NA	NA
1512	scaffold_10	456950	457861	911	114	yes	313207	-
1513	scaffold_10	461212	462521	1309	151	no	NA	NA
1514	scaffold_10	473846	475096	1250	111	yes	407213	-
1515	scaffold_10	476301	477076	775	40	no	NA	NA
1516	scaffold_10	490447	490494	47	12	no	NA	NA
1517	scaffold_10	490586	491989	1403	196	yes	423192	-
1518	scaffold_10	494158	495247	1089	119	yes	16962	+
1519	scaffold_10	499759	501021	1262	140	yes	313213	-
1520	scaffold_10	502310	503730	1420	159	yes	313215	+
1521	scaffold_10	507509	507549	40	8	no	NA	NA
1522	scaffold_10	508013	508749	736	46	yes	313218	-
1523	scaffold_10	524788	526169	1381	129	yes	291966	+
1524	scaffold_10	529542	530541	999	126	yes	313233	-
1525	scaffold_10	532695	534026	1331	106	yes	389873	-
1526	scaffold_10	543933	545058	1125	162	no	NA	NA
1527	scaffold_10	555141	555398	257	14	yes	291972	-
1528	scaffold_10	570888	572046	1158	129	yes	17110	-
1529	scaffold_10	585381	586445	1064	110	yes	407234	-
1530	scaffold_10	586831	586839	8	4	no	NA	NA
1531	scaffold_10	592082	593210	1128	100	yes	313248	-
1532	scaffold_10	594302	595812	1510	169	yes	313252	+
1533	scaffold_10	601573	602591	1018	129	yes	313254	+
1534	scaffold_10	610131	611287	1156	96	yes	229897	-
1535	scaffold_10	613142	614103	961	138	yes	313263	+
1536	scaffold_10	628348	629579	1231	120	no	NA	NA
1537	scaffold_10	630140	630463	323	17	no	NA	NA
1538	scaffold_10	634271	634333	62	10	no	NA	NA
1539	scaffold_10	634772	635079	307	48	no	NA	NA
1540	scaffold_10	635578	635590	12	6	no	NA	NA
1541	scaffold_10	635921	636026	105	10	no	NA	NA
1542	scaffold_10	638124	638890	766	97	yes	229898	-
1543	scaffold_10	641552	641819	267	30	yes	313270	+
1544	scaffold_10	651699	651711	12	3	no	NA	NA
1545	scaffold_10	651958	652649	691	54	yes	407247	-
1546	scaffold_10	657411	658545	1134	110	yes	313298	-
1547	scaffold_10	661659	662529	870	112	yes	17316	-
1548	scaffold_10	663483	664856	1373	143	yes	313300	+
1549	scaffold_10	664999	665028	29	10	no	NA	NA
1550	scaffold_10	670424	670432	8	3	no	NA	NA
1551	scaffold_10	670774	671756	982	100	yes	313302,423222	-,+
1552	scaffold_10	673067	673104	37	3	no	NA	NA
1553	scaffold_10	673336	674765	1429	178	yes	385186	+
1554	scaffold_10	674996	676220	1224	147	yes	385186	+
1555	scaffold_10	680676	681580	904	96	no	NA	NA
1556	scaffold_10	682145	683171	1026	140	yes	423224	-
1557	scaffold_10	686477	687682	1205	171	yes	291999,313309	-,-
1558	scaffold_10	689705	690667	962	107	yes	313310	+
1559	scaffold_10	693105	695471	2366	199	yes	365383	+
1560	scaffold_10	710362	710589	227	18	yes	313322	+
1561	scaffold_10	710861	711130	269	28	no	NA	NA
1562	scaffold_10	715530	716773	1243	125	yes	229914	-
1563	scaffold_10	721094	722292	1198	143	yes	407265	+
1564	scaffold_10	725741	725747	6	4	no	NA	NA
1565	scaffold_10	726162	727114	952	88	yes	17633	-
1566	scaffold_10	729733	730900	1167	143	yes	313331	+
1567	scaffold_10	735692	736122	430	23	yes	423236	+
1568	scaffold_10	741409	742720	1311	135	yes	389913	-
1569	scaffold_10	742864	743852	988	151	yes	389913	-
1570	scaffold_10	750296	751431	1135	132	yes	313346,313349	-,+
1571	scaffold_10	751792	752865	1073	110	yes	313346,313349	-,+
1572	scaffold_10	755257	755691	434	52	yes	313351	+
1573	scaffold_10	756176	756185	9	4	no	NA	NA
1574	scaffold_10	760340	761508	1168	104	yes	407276	-
1575	scaffold_10	763531	764497	966	134	yes	313359	-
1576	scaffold_10	767937	769070	1133	147	yes	313363	-
1577	scaffold_10	770036	771177	1141	114	yes	313364	+
1578	scaffold_10	777781	779008	1227	122	yes	407282	-
1579	scaffold_10	782417	783582	1165	145	no	NA	NA
1580	scaffold_10	813150	814261	1111	76	no	NA	NA
1581	scaffold_10	830091	831407	1316	186	yes	367448,423252	-,+
1582	scaffold_10	831660	832957	1297	163	yes	423252	+
1583	scaffold_10	850394	851197	803	58	yes	385197	+
1584	scaffold_10	852109	852117	8	4	no	NA	NA
1585	scaffold_10	858797	860331	1534	182	yes	313397	+
1586	scaffold_10	875268	875960	692	48	no	NA	NA
1587	scaffold_10	887257	888588	1331	166	yes	407298	-
1588	scaffold_10	894511	894577	66	7	yes	229951	-
1589	scaffold_10	903223	903843	620	31	yes	292042	-
1590	scaffold_10	911784	912914	1130	135	yes	18050	+
1591	scaffold_10	915924	916908	984	108	no	NA	NA
1592	scaffold_10	917055	918200	1145	82	yes	407302	-
1593	scaffold_10	921537	922036	499	48	no	NA	NA
1594	scaffold_10	926084	926485	401	58	yes	313419	+
1595	scaffold_10	928321	928716	395	58	yes	313421	+
1596	scaffold_10	931914	932683	769	102	yes	313422	-
1597	scaffold_10	935200	936606	1406	137	yes	313425	+
1598	scaffold_10	944550	946260	1710	166	yes	292051	+
1599	scaffold_10	955700	957344	1644	184	yes	292053,292054	-,-
1600	scaffold_10	959031	959468	437	40	yes	313432	-
1601	scaffold_10	960299	961439	1140	86	yes	292056	+
1602	scaffold_10	974032	974608	576	57	yes	313439	+
1603	scaffold_10	979386	980583	1197	110	yes	18288	+
1604	scaffold_10	988217	989680	1463	118	yes	423277	-
1605	scaffold_10	997007	997033	26	8	no	NA	NA
1606	scaffold_10	1003972	1005648	1676	133	yes	18317	+
1607	scaffold_10	1009813	1010997	1184	126	yes	313453	-
1608	scaffold_10	1011491	1012549	1058	151	yes	292068	+
1609	scaffold_10	1017440	1018768	1328	147	yes	229975	+
1610	scaffold_10	1019696	1021089	1393	147	yes	18395	+
1611	scaffold_10	1024624	1026252	1628	181	yes	407327	-
1612	scaffold_10	1027592	1028603	1011	130	yes	423285	+
1613	scaffold_10	1041029	1041356	327	27	yes	18522	+
1614	scaffold_10	1072898	1074532	1634	140	yes	18604	-
1615	scaffold_10	1075446	1077511	2065	236	yes	313466	+
1616	scaffold_10	1078481	1078549	68	6	yes	313467	-
1617	scaffold_10	1078681	1078718	37	8	yes	313467	-
1618	scaffold_10	1080490	1081469	979	96	yes	313470	-
1619	scaffold_10	1098179	1099639	1460	173	yes	292084	+
1620	scaffold_10	1108154	1109587	1433	149	yes	313483	-
1621	scaffold_10	1117790	1118967	1177	149	yes	313488	-
1622	scaffold_10	1119574	1120900	1326	138	yes	407343	+
1623	scaffold_10	1131968	1133207	1239	124	yes	313492	-
1624	scaffold_10	1146347	1147144	797	83	yes	18801,313495	+,+
1625	scaffold_10	1165363	1167092	1729	228	yes	313501	+
1626	scaffold_10	1173001	1174207	1206	136	yes	313502	-
1627	scaffold_10	1181656	1181970	314	26	yes	313508	+
1628	scaffold_10	1182089	1182579	490	59	yes	313508	+
1629	scaffold_10	1188494	1190058	1564	144	yes	292099	-
1630	scaffold_10	1190624	1190664	40	6	no	NA	NA
1631	scaffold_10	1196202	1196225	23	4	no	NA	NA
1632	scaffold_10	1196534	1197136	602	50	no	NA	NA
1633	scaffold_10	1206732	1206887	155	14	no	NA	NA
1634	scaffold_10	1214854	1214934	80	16	yes	423309	-
1635	scaffold_10	1215119	1215243	124	18	yes	423309	-
1636	scaffold_10	1223947	1224905	958	61	yes	18893	+
1637	scaffold_10	1231219	1231238	19	6	no	NA	NA
1638	scaffold_10	1239420	1240162	742	45	no	NA	NA
1639	scaffold_10	1244926	1245880	954	114	yes	313532	+
1640	scaffold_10	1252325	1252372	47	8	yes	423316	+
1641	scaffold_10	1260281	1261242	961	112	yes	18975,313536	-,-
1642	scaffold_10	1262458	1263945	1487	156	yes	313537	-
1643	scaffold_10	1275591	1275783	192	22	no	NA	NA
1644	scaffold_10	1275916	1276862	946	110	yes	18980	-
1645	scaffold_10	1277412	1278508	1096	128	yes	18980,313543	-,-
1646	scaffold_10	1283111	1284043	932	119	yes	390002	+
1647	scaffold_10	1291873	1292156	283	20	yes	390003	+
1648	scaffold_10	1316916	1316922	6	4	no	NA	NA
1649	scaffold_10	1323021	1324792	1771	226	yes	407387	+
1650	scaffold_10	1330648	1331878	1230	160	yes	423331	-
1651	scaffold_10	1332028	1333082	1054	124	yes	423331,313560	-,+
1652	scaffold_10	1341130	1341357	227	22	no	NA	NA
1653	scaffold_10	1343917	1343927	10	4	yes	313562	-
1654	scaffold_10	1344049	1345589	1540	185	yes	313562	-
1655	scaffold_10	1349388	1350834	1446	121	no	NA	NA
1656	scaffold_10	1363522	1363535	13	6	no	NA	NA
1657	scaffold_10	1363629	1364593	964	131	yes	407397	-
1658	scaffold_10	1367549	1367907	358	28	yes	313565	-
1659	scaffold_10	1368481	1369569	1088	158	yes	313567	+
1660	scaffold_10	1382798	1384357	1559	124	yes	292142	+
1661	scaffold_10	1395201	1395392	191	10	no	NA	NA
1662	scaffold_10	1396095	1396931	836	54	no	NA	NA
1663	scaffold_10	1406711	1407709	998	88	yes	423345	-
1664	scaffold_10	1410581	1412962	2381	214	yes	216113,423346	-,+
1665	scaffold_10	1413986	1414892	906	91	yes	423348	+
1666	scaffold_10	1419184	1419766	582	72	no	NA	NA
1667	scaffold_10	1420197	1420235	38	8	no	NA	NA
1668	scaffold_10	1423970	1425085	1115	102	yes	216255	+
1669	scaffold_10	1428746	1429890	1144	149	yes	242602	+
1670	scaffold_10	1446382	1446809	427	51	no	NA	NA
1671	scaffold_10	1476704	1477882	1178	96	yes	313614	-
1672	scaffold_10	1482164	1483074	910	106	yes	292159	+
1673	scaffold_10	1484953	1486236	1283	134	yes	313615	+
1674	scaffold_10	1490395	1491495	1100	153	yes	19416	-
1675	scaffold_10	1491740	1492082	342	22	no	NA	NA
1676	scaffold_10	1499238	1500406	1168	127	yes	313620,423361	+,-
1677	scaffold_10	1500686	1502170	1484	165	yes	313620,423361	+,-
1678	scaffold_10	1502861	1504044	1183	142	yes	313622	+
1679	scaffold_10	1507014	1508076	1062	142	yes	292165	-
1680	scaffold_10	1511517	1512650	1133	136	yes	313625	-
1681	scaffold_10	1513881	1514964	1083	101	yes	390039	+
1682	scaffold_10	1519443	1519459	16	8	no	NA	NA
1683	scaffold_10	1519733	1521079	1346	149	yes	292168	-
1684	scaffold_25	6752	7371	619	77	no	NA	NA
1685	scaffold_25	12087	12692	605	76	no	NA	NA
1686	scaffold_25	20423	20435	12	4	no	NA	NA
1687	scaffold_25	21861	22732	871	89	yes	82272	+
1688	scaffold_25	27986	29076	1090	99	yes	320987	-
1689	scaffold_25	32287	32666	379	32	yes	320991	+
1690	scaffold_25	36638	38022	1384	142	yes	426158	-
1691	scaffold_25	40440	41860	1420	157	yes	320997	+
1692	scaffold_25	47782	48490	708	90	yes	321003	+
1693	scaffold_25	52985	54023	1038	97	yes	321004	-
1694	scaffold_25	56648	57769	1121	120	yes	295426	-
1695	scaffold_25	58664	60006	1342	140	yes	426161	+
1696	scaffold_25	63487	64436	949	129	yes	321013,321016	-,+
1697	scaffold_25	64669	65576	907	86	yes	321013,321016	-,+
1698	scaffold_25	68967	69758	791	61	yes	392774	+
1699	scaffold_25	72177	73093	916	107	yes	321019	-
1700	scaffold_25	79028	80366	1338	167	yes	321021	+
1701	scaffold_25	80478	80499	21	5	no	NA	NA
1702	scaffold_25	86372	88079	1707	204	yes	426168	+
1703	scaffold_25	97640	98635	995	135	yes	321036	-
1704	scaffold_25	106274	107273	999	65	yes	82478	+
1705	scaffold_25	117909	117992	83	8	yes	82495	+
1706	scaffold_25	130041	130918	877	102	no	NA	NA
1707	scaffold_25	136029	136052	23	6	yes	372794	+
1708	scaffold_25	140930	142403	1473	136	yes	321045	+
1709	scaffold_25	149894	150543	649	79	no	NA	NA
1710	scaffold_25	150670	151405	735	73	yes	392787	-
1711	scaffold_25	152933	153952	1019	117	yes	392789	-
1712	scaffold_25	243383	243849	466	39	yes	82626	+
1713	scaffold_25	252942	253632	690	84	yes	392794	+
1714	scaffold_25	259716	260665	949	71	yes	410334	+
1715	scaffold_25	273625	274254	629	59	yes	392797	+
1716	scaffold_25	274745	274752	7	4	no	NA	NA
1717	scaffold_25	286354	286438	84	28	no	NA	NA
1718	scaffold_25	291928	292687	759	94	no	NA	NA
1719	scaffold_25	296849	297056	207	42	yes	392798	+
1720	scaffold_25	303076	304275	1199	78	yes	426187	+
1721	scaffold_25	307757	307991	234	36	no	NA	NA
1722	scaffold_25	308085	308522	437	53	yes	321076	-
1723	scaffold_25	316179	316230	51	6	yes	426189	+
1724	scaffold_25	320274	321228	954	127	no	NA	NA
1725	scaffold_25	329518	331254	1736	199	yes	232821	-
1726	scaffold_25	333043	335042	1999	185	no	NA	NA
1727	scaffold_25	342097	343261	1164	97	yes	392804	-
1728	scaffold_25	348325	348435	110	20	no	NA	NA
1729	scaffold_25	360544	361573	1029	104	yes	82811	+
1730	scaffold_25	363807	363815	8	4	no	NA	NA
1731	scaffold_25	370589	372356	1767	166	yes	426196	-
1732	scaffold_25	374158	375602	1444	145	yes	321097	+
1733	scaffold_25	393812	394612	800	73	yes	426200	-
1734	scaffold_25	406439	407734	1295	95	yes	219406	-
1735	scaffold_25	429462	430160	698	58	yes	392820	-
1736	scaffold_25	484366	484677	311	27	yes	83001	-
1737	scaffold_25	504028	504449	421	40	yes	295499	-
1738	scaffold_25	507218	507325	107	16	yes	83081	-
1739	scaffold_25	507461	507662	201	18	yes	83081	-
1740	scaffold_25	509420	510491	1071	110	yes	392833	-
1741	scaffold_25	555876	555889	13	6	yes	426230	-
1742	scaffold_25	556240	556260	20	8	yes	426230	-
1743	scaffold_25	597143	597164	21	6	yes	372890	-
1744	scaffold_25	600102	600109	7	4	yes	426240	+
1745	scaffold_25	600302	600339	37	5	yes	426240	+
1746	scaffold_25	628658	629358	700	61	yes	207298,321159,321161	-,-,-
1747	scaffold_25	634575	635610	1035	142	yes	426247	-
1748	scaffold_25	636641	637893	1252	141	yes	295525	+
1749	scaffold_25	642440	643864	1424	190	yes	410426	+
1750	scaffold_25	654180	656025	1845	182	yes	321169	+
1751	scaffold_25	656146	656150	4	4	no	NA	NA
1752	scaffold_25	670968	672010	1042	155	yes	219427	-
1753	scaffold_25	710207	711785	1578	126	no	NA	NA
1754	scaffold_25	716025	717455	1430	139	yes	83335	-
1755	scaffold_25	719835	721132	1297	109	yes	83344	+
1756	scaffold_25	723761	724944	1183	82	yes	392871	-
1757	scaffold_25	730848	730856	8	4	no	NA	NA
1758	scaffold_25	735781	735854	73	10	no	NA	NA
1759	scaffold_25	736404	736694	290	18	yes	83384	-
1760	scaffold_25	737237	737245	8	4	yes	83384	-
1761	scaffold_25	743541	744528	987	104	yes	295550	+
1762	scaffold_25	754522	755562	1040	62	no	NA	NA
1763	scaffold_25	756264	756872	608	44	yes	295551	+
1764	scaffold_25	757085	757099	14	4	yes	295551	+
1765	scaffold_25	766471	767678	1207	150	yes	83441	+
1766	scaffold_25	773918	774557	639	85	no	NA	NA
1767	scaffold_25	802022	803093	1071	144	yes	219451	-
1768	scaffold_25	806084	807036	952	98	no	NA	NA
1769	scaffold_25	812802	814460	1658	171	yes	426275	+
1770	scaffold_25	821104	821109	5	4	no	NA	NA
1771	scaffold_25	821263	822499	1236	161	yes	321238	-
1772	scaffold_25	823683	825211	1528	152	yes	321246	+
1773	scaffold_25	830145	830976	831	100	yes	372950,426279	-,+
1774	scaffold_25	848343	849364	1021	115	yes	83649,392896	+,-
1775	scaffold_25	861895	863233	1338	140	yes	410469	-
1776	scaffold_25	875433	876830	1397	112	yes	426289	+
1777	scaffold_25	882058	882998	940	93	yes	321272	+
1778	scaffold_25	886253	887493	1240	116	yes	392904	-
1779	scaffold_25	895177	895198	21	6	yes	321282	+
1780	scaffold_25	895321	896411	1090	103	yes	321282,372962	+,+
1781	scaffold_25	915008	915918	910	114	yes	321293,426299	+,-
1782	scaffold_25	916237	917490	1253	146	yes	321293,426299	+,-
1783	scaffold_25	920304	920832	528	75	yes	321295	-
1784	scaffold_25	925062	925885	823	66	yes	392914	+
1785	scaffold_25	932548	933627	1079	137	yes	321300,392916	-,+
1786	scaffold_25	934105	935090	985	118	yes	321300,392916	-,+
1787	scaffold_25	940618	941405	787	90	yes	321303	-
1788	scaffold_25	941788	942993	1205	160	yes	321303,426306	-,+
1789	scaffold_25	946845	948265	1420	210	yes	321307	+
1790	scaffold_25	957135	958273	1138	70	no	NA	NA
1791	scaffold_25	959098	961494	2396	83	no	NA	NA
1792	scaffold_25	962670	963889	1219	73	no	NA	NA
1793	scaffold_5	7082	7111	29	6	no	NA	NA
1794	scaffold_5	7230	7729	499	48	no	NA	NA
1795	scaffold_5	34521	34713	192	15	no	NA	NA
1796	scaffold_5	34897	35250	353	26	no	NA	NA
1797	scaffold_5	35422	35471	49	16	no	NA	NA
1798	scaffold_5	35918	36147	229	33	no	NA	NA
1799	scaffold_5	36663	36709	46	8	no	NA	NA
1800	scaffold_5	41053	41713	660	84	no	NA	NA
1801	scaffold_5	41855	42317	462	50	no	NA	NA
1802	scaffold_5	55635	56874	1239	141	yes	139385	+
1803	scaffold_5	64926	66279	1353	145	yes	309558	+
1804	scaffold_5	72366	72414	48	12	no	NA	NA
1805	scaffold_5	72811	72855	44	9	no	NA	NA
1806	scaffold_5	95540	95573	33	6	no	NA	NA
1807	scaffold_5	101741	102451	710	74	no	NA	NA
1808	scaffold_5	103732	103969	237	27	yes	421806	+
1809	scaffold_5	141313	141471	158	14	yes	421809	-
1810	scaffold_5	144391	145791	1400	164	no	NA	NA
1811	scaffold_5	178257	179547	1290	189	yes	388465	+
1812	scaffold_5	194386	195363	977	80	yes	421815	+
1813	scaffold_5	262860	262898	38	13	yes	378076	+
1814	scaffold_5	272796	272986	190	22	yes	241170	-
1815	scaffold_5	273165	273180	15	4	yes	241170	-
1816	scaffold_5	275200	275886	686	77	yes	309614	-
1817	scaffold_5	293051	294358	1307	125	yes	408341	+
1818	scaffold_5	306024	306598	574	54	no	NA	NA
1819	scaffold_5	310584	311519	935	128	yes	408345	+
1820	scaffold_5	321175	321787	612	52	yes	388481	+
1821	scaffold_5	334039	335278	1239	183	yes	290306,378096	+,-
1822	scaffold_5	335361	335368	7	3	yes	290306	+
1823	scaffold_5	350313	351350	1037	137	yes	309640	-
1824	scaffold_5	365602	366676	1074	139	no	NA	NA
1825	scaffold_5	386720	387731	1011	156	yes	309646	-
1826	scaffold_5	388105	388138	33	9	no	NA	NA
1827	scaffold_5	395155	395167	12	6	yes	378121	-
1828	scaffold_5	397377	398024	647	62	yes	309648	+
1829	scaffold_5	406660	407507	847	92	no	NA	NA
1830	scaffold_5	412773	414004	1231	138	yes	388496	+
1831	scaffold_5	449883	449891	8	4	no	NA	NA
1832	scaffold_5	451239	452356	1117	142	yes	408379	+
1833	scaffold_5	470342	471451	1109	135	yes	378153	-
1834	scaffold_5	475945	476804	859	74	yes	421857	+
1835	scaffold_5	481531	482574	1043	155	no	NA	NA
1836	scaffold_5	521898	522145	247	28	no	NA	NA
1837	scaffold_5	522245	522605	360	28	yes	388509	-
1838	scaffold_5	525505	525543	38	7	yes	384960	-
1839	scaffold_5	538315	539286	971	81	yes	309692	+
1840	scaffold_5	542609	543378	769	109	yes	140004	+
1841	scaffold_5	545386	546750	1364	122	yes	309694	-
1842	scaffold_5	558647	558943	296	19	yes	309699	-
1843	scaffold_5	570366	570954	588	54	yes	214846	+
1844	scaffold_5	577465	577851	386	49	no	NA	NA
1845	scaffold_5	577983	578010	27	7	no	NA	NA
1846	scaffold_5	581912	581955	43	12	yes	309703	+
1847	scaffold_5	588614	589838	1224	109	yes	408413,421874	-,+
1848	scaffold_5	590069	591285	1216	130	yes	408413,421874	-,+
1849	scaffold_5	598325	599593	1268	129	yes	140120,309710	-,-
1850	scaffold_5	662771	663925	1154	122	no	NA	NA
1851	scaffold_5	671231	671245	14	6	no	NA	NA
1852	scaffold_5	671595	672221	626	42	yes	421878	-
1853	scaffold_5	680260	680276	16	5	no	NA	NA
1854	scaffold_5	680407	681460	1053	138	no	NA	NA
1855	scaffold_5	729887	731247	1360	174	yes	378195	-
1856	scaffold_5	760037	761228	1191	122	no	NA	NA
1857	scaffold_5	775268	776373	1105	83	yes	309734	+
1858	scaffold_5	782561	783387	826	75	no	NA	NA
1859	scaffold_5	804826	804870	44	8	yes	214804	+
1860	scaffold_5	809106	810305	1199	110	yes	408473,421907	+,+
1861	scaffold_5	828288	829656	1368	167	yes	309765	+
1862	scaffold_5	871318	872411	1093	120	yes	309771,309774	+,+
1863	scaffold_5	877492	878368	876	94	yes	214856	+
1864	scaffold_5	890314	890345	31	6	no	NA	NA
1865	scaffold_5	890451	891677	1226	125	yes	241236	+
1866	scaffold_5	932340	933154	814	92	no	NA	NA
1867	scaffold_5	934017	934790	773	93	yes	388569	+
1868	scaffold_5	939217	940339	1122	128	yes	309792	+
1869	scaffold_5	942248	944170	1922	190	yes	309793	-
1870	scaffold_5	947842	948208	366	39	yes	241247	-
1871	scaffold_5	950537	951190	653	63	yes	309798,421937	+,+
1872	scaffold_5	952992	953877	885	113	yes	408514	-
1873	scaffold_5	957051	958405	1354	179	yes	140506	+
1874	scaffold_5	961519	961849	330	60	yes	309804	-
1875	scaffold_5	970671	971532	861	123	yes	421947	+
1876	scaffold_5	971629	971656	27	6	no	NA	NA
1877	scaffold_5	993708	994936	1228	138	yes	309813	+
1878	scaffold_5	998059	999258	1199	107	yes	241258	-
1879	scaffold_5	1003777	1004810	1033	98	yes	290454	+
1880	scaffold_5	1054737	1054804	67	8	yes	388594	+
1881	scaffold_5	1066749	1067762	1013	107	yes	309847	+
1882	scaffold_5	1076300	1077196	896	100	yes	408538,421959	-,+
1883	scaffold_5	1084021	1084657	636	66	yes	290466	-
1884	scaffold_5	1086463	1087220	757	73	yes	309853	-
1885	scaffold_5	1093453	1093972	519	28	yes	421964	-
1886	scaffold_5	1106249	1107251	1002	106	yes	309861	+
1887	scaffold_5	1112871	1114268	1397	159	yes	388608	+
1888	scaffold_5	1130890	1131469	579	61	yes	388612	+
1889	scaffold_5	1135421	1135473	52	12	yes	309868	-
1890	scaffold_5	1148481	1149400	919	74	yes	388615	-
1891	scaffold_5	1153056	1153716	660	69	no	NA	NA
1892	scaffold_5	1157251	1157593	342	18	yes	408560	-
1893	scaffold_5	1166256	1167387	1131	97	yes	421977	+
1894	scaffold_5	1171086	1172850	1764	145	yes	309874	+
1895	scaffold_5	1198947	1199317	370	26	yes	309884	+
1896	scaffold_5	1200908	1201158	250	44	no	NA	NA
1897	scaffold_5	1205769	1205814	45	8	yes	309886	-
1898	scaffold_5	1206144	1206217	73	12	yes	309886	-
1899	scaffold_5	1207048	1207694	646	64	yes	140794	+
1900	scaffold_5	1209236	1209570	334	37	yes	309888	+
1901	scaffold_5	1212081	1212366	285	37	yes	309889	+
1902	scaffold_5	1215266	1215781	515	52	yes	309890	+
1903	scaffold_5	1216115	1216251	136	6	no	NA	NA
1904	scaffold_5	1220821	1221080	259	19	no	NA	NA
1905	scaffold_5	1221417	1222048	631	58	yes	421988	-
1906	scaffold_5	1222707	1224412	1705	219	yes	290503	-
1907	scaffold_5	1225176	1226955	1779	223	yes	140889	-
1908	scaffold_5	1229483	1230723	1240	182	yes	309893	+
1909	scaffold_5	1242769	1243016	247	35	yes	309901	+
1910	scaffold_5	1246250	1246760	510	43	yes	309902	+
1911	scaffold_5	1252561	1253697	1136	105	yes	140961,309908	-,+
1912	scaffold_5	1253874	1255141	1267	120	yes	140961,309908	-,+
1913	scaffold_5	1255762	1257163	1401	162	yes	309910	+
1914	scaffold_5	1259237	1259717	480	48	yes	309912	+
1915	scaffold_5	1269154	1270000	846	105	yes	309917	+
1916	scaffold_5	1271639	1272549	910	121	yes	290517	-
1917	scaffold_5	1274281	1274609	328	66	yes	309919	+
1918	scaffold_5	1284930	1285120	190	22	yes	378325	+
1919	scaffold_5	1292181	1293082	901	84	yes	141021,309932	-,+
1920	scaffold_5	1303566	1304426	860	106	yes	141048	+
1921	scaffold_5	1309560	1310237	677	57	yes	241287	+
1922	scaffold_5	1318163	1319077	914	103	yes	309940	-
1923	scaffold_5	1322233	1323148	915	88	yes	388649	+
1924	scaffold_5	1327242	1327551	309	27	yes	290530	+
1925	scaffold_5	1346156	1347243	1087	116	no	NA	NA
1926	scaffold_5	1354091	1354942	851	106	no	NA	NA
1927	scaffold_5	1358472	1359594	1122	139	yes	309952	+
1928	scaffold_5	1361575	1362406	831	95	yes	309953	-
1929	scaffold_5	1362715	1362760	45	5	no	NA	NA
1930	scaffold_5	1369407	1369951	544	53	yes	422019	+
1931	scaffold_5	1376195	1376844	649	43	yes	309958	+
1932	scaffold_5	1377120	1377132	12	6	yes	309958	+
1933	scaffold_5	1395264	1396156	892	83	yes	290546	-
1934	scaffold_5	1403458	1404058	600	46	yes	422023	-
1935	scaffold_5	1410851	1411361	510	47	yes	290548	-
1936	scaffold_5	1413599	1414157	558	83	yes	309967	-
1937	scaffold_5	1424473	1425294	821	103	yes	388669	+
1938	scaffold_5	1427937	1429657	1720	183	no	NA	NA
1939	scaffold_5	1449672	1450519	847	83	yes	388675	+
1940	scaffold_5	1455416	1456052	636	99	no	NA	NA
1941	scaffold_5	1456374	1456382	8	4	no	NA	NA
1942	scaffold_5	1458630	1458799	169	24	no	NA	NA
1943	scaffold_5	1458903	1459019	116	18	yes	309984	-
1944	scaffold_5	1459099	1459313	214	21	yes	309984	-
1945	scaffold_5	1461370	1462492	1122	147	yes	141304	-
1946	scaffold_5	1465643	1466645	1002	124	yes	309987	-
1947	scaffold_5	1471794	1473094	1300	202	no	NA	NA
1948	scaffold_5	1477482	1478223	741	81	yes	422037	-
1949	scaffold_5	1503884	1505316	1432	171	yes	310008,310010	-,+
1950	scaffold_5	1505620	1506768	1148	146	yes	310008,310010	-,+
1951	scaffold_5	1512638	1513556	918	63	yes	310015	-
1952	scaffold_5	1526149	1526984	835	70	yes	241327	-
1953	scaffold_5	1527568	1529095	1527	154	yes	310020	+
1954	scaffold_5	1530834	1531773	939	117	yes	310025,310026	+,+
1955	scaffold_5	1532898	1533290	392	51	yes	310028	+
1956	scaffold_5	1533712	1534833	1121	149	yes	310028	+
1957	scaffold_5	1540926	1541074	148	8	no	NA	NA
1958	scaffold_5	1541147	1542163	1016	124	yes	310030,310032	-,+
1959	scaffold_5	1543106	1543392	286	36	yes	310032	+
1960	scaffold_5	1545239	1546395	1156	137	yes	310035	-
1961	scaffold_5	1550978	1552104	1126	108	yes	310037,310038	-,+
1962	scaffold_5	1552435	1553169	734	90	yes	310037,310038	-,+
1963	scaffold_5	1558244	1558941	697	77	yes	388694	-
1964	scaffold_5	1559661	1560846	1185	136	yes	310044	+
1965	scaffold_5	1565387	1566361	974	107	yes	388697	+
1966	scaffold_5	1574636	1575947	1311	114	yes	310051	+
1967	scaffold_5	1611288	1612573	1285	110	yes	422060	-
1968	scaffold_5	1628046	1629029	983	82	yes	214766	-
1969	scaffold_5	1631461	1632163	702	80	no	NA	NA
1970	scaffold_5	1632358	1632365	7	4	no	NA	NA
1971	scaffold_5	1641837	1644475	2638	281	yes	290600,408680	+,-
1972	scaffold_5	1658755	1660551	1796	200	yes	310080,388716	+,+
1973	scaffold_5	1660972	1662160	1188	127	yes	310080	+
1974	scaffold_5	1662305	1662357	52	4	no	NA	NA
1975	scaffold_5	1667942	1669379	1437	151	yes	422069	-
1976	scaffold_5	1677780	1678772	992	136	yes	141850	-
1977	scaffold_1	21084	22022	938	69	yes	412520	-
1978	scaffold_1	49746	49859	113	8	no	NA	NA
1979	scaffold_1	68052	69445	1393	164	no	NA	NA
1980	scaffold_1	103589	104653	1064	67	yes	304307	-
1981	scaffold_1	108072	109033	961	114	yes	304312,386349	-,+
1982	scaffold_1	109319	110678	1359	152	yes	304312,386349	-,+
1983	scaffold_1	124581	126247	1666	147	yes	2358	-
1984	scaffold_1	126805	127586	781	85	yes	366666	+
1985	scaffold_1	140905	141964	1059	126	no	NA	NA
1986	scaffold_1	142499	143070	571	57	no	NA	NA
1987	scaffold_1	143192	143220	28	8	no	NA	NA
1988	scaffold_1	145379	147354	1975	200	yes	287822	+
1989	scaffold_1	149463	150474	1011	103	no	NA	NA
1990	scaffold_1	156803	157748	945	106	yes	2740,304328	-,-
1991	scaffold_1	164551	165157	606	24	yes	287824	-
1992	scaffold_1	175461	175478	17	8	no	NA	NA
1993	scaffold_1	184465	185263	798	98	yes	304331	-
1994	scaffold_1	189905	190095	190	18	yes	287826,304333	-,-
1995	scaffold_1	191393	191758	365	37	yes	287827	-
1996	scaffold_1	192845	192919	74	12	no	NA	NA
1997	scaffold_1	193556	193883	327	39	yes	304335	-
1998	scaffold_1	197784	197892	108	8	no	NA	NA
1999	scaffold_1	198216	198224	8	4	no	NA	NA
2000	scaffold_1	198541	198916	375	31	yes	419723	-
2001	scaffold_1	200241	201678	1437	198	yes	304338	+
2002	scaffold_1	204808	206099	1291	142	yes	386361	-
2003	scaffold_1	217668	219020	1352	177	yes	412551	-
2004	scaffold_1	227052	228212	1160	127	no	NA	NA
2005	scaffold_1	228712	230042	1330	163	yes	226253	+
2006	scaffold_1	236525	236925	400	42	no	NA	NA
2007	scaffold_1	238877	240432	1555	158	yes	386365	+
2008	scaffold_1	246609	249823	3214	391	no	NA	NA
2009	scaffold_1	273765	275112	1347	192	yes	366686	+
2010	scaffold_1	303395	304682	1287	210	no	NA	NA
2011	scaffold_1	314283	315160	877	80	yes	238937	-
2012	scaffold_1	319899	320821	922	121	yes	3349	-
2013	scaffold_1	322131	322992	861	90	yes	304392	-
2014	scaffold_1	325429	326495	1066	104	yes	3377,3378	+,+
2015	scaffold_1	329389	330759	1370	193	yes	3403	+
2016	scaffold_1	334157	335036	879	84	yes	3406	-
2017	scaffold_1	339333	340417	1084	162	yes	386375	-
2018	scaffold_1	341444	342864	1420	132	yes	304399	+
2019	scaffold_1	344334	345662	1328	147	yes	3431	+
2020	scaffold_1	347705	348894	1189	166	yes	304404	+
2021	scaffold_1	353003	354244	1241	149	yes	419747	+
2022	scaffold_1	355945	356553	608	68	yes	304405	+
2023	scaffold_1	362039	362947	908	115	yes	386381	-
2024	scaffold_1	365995	366919	924	96	yes	366698	+
2025	scaffold_1	375502	375598	96	3	no	NA	NA
2026	scaffold_1	375856	377029	1173	124	yes	3494	-
2027	scaffold_1	378615	379742	1127	116	yes	3525	-
2028	scaffold_1	383975	384866	891	79	no	NA	NA
2029	scaffold_1	400596	401985	1389	149	yes	304423	+
2030	scaffold_1	404395	405512	1117	106	no	NA	NA
2031	scaffold_1	407412	407631	219	10	yes	3579	-
2032	scaffold_1	416198	417152	954	93	yes	304428	-
2033	scaffold_1	419030	420666	1636	207	yes	212196	-
2034	scaffold_1	421198	422725	1527	168	yes	287867	+
2035	scaffold_1	426489	427497	1008	121	yes	412594	-
2036	scaffold_1	432041	432981	940	96	yes	419758	+
2037	scaffold_1	439350	440677	1327	156	yes	386392	+
2038	scaffold_1	450403	451519	1116	141	yes	304440	+
2039	scaffold_1	456542	457476	934	76	no	NA	NA
2040	scaffold_1	464578	465038	460	20	yes	304449	+
2041	scaffold_1	475468	476580	1112	155	yes	419767	-
2042	scaffold_1	483460	483520	60	8	yes	3749	-
2043	scaffold_1	483602	485210	1608	168	yes	3749	-
2044	scaffold_1	489089	490587	1498	213	yes	304460	-
2045	scaffold_1	490986	491028	42	6	yes	304460	-
2046	scaffold_1	494770	495030	260	30	yes	304464	+
2047	scaffold_1	507568	508758	1190	95	yes	287882	+
2048	scaffold_1	525633	526708	1075	150	yes	419776	-
2049	scaffold_1	529950	531121	1171	118	yes	226303,304496	+,-
2050	scaffold_1	535092	536546	1454	159	yes	412620	+
2051	scaffold_1	536873	536883	10	4	no	NA	NA
2052	scaffold_1	537023	537027	4	4	no	NA	NA
2053	scaffold_1	543372	543379	7	4	no	NA	NA
2054	scaffold_1	553696	555203	1507	114	yes	384608	-
2055	scaffold_1	560025	561231	1206	158	yes	419782	-
2056	scaffold_1	563488	563501	13	6	no	NA	NA
2057	scaffold_1	569811	571003	1192	148	yes	412627	-
2058	scaffold_1	572213	572275	62	12	no	NA	NA
2059	scaffold_1	572517	573265	748	104	yes	386413	-
2060	scaffold_1	575946	577038	1092	117	yes	304518	-
2061	scaffold_1	578438	579576	1138	162	yes	304522	+
2062	scaffold_1	592636	592675	39	9	no	NA	NA
2063	scaffold_1	592765	592940	175	28	no	NA	NA
2064	scaffold_1	595461	596752	1291	113	yes	212586	+
2065	scaffold_1	609675	611132	1457	123	yes	287899	-
2066	scaffold_1	620079	621043	964	57	no	NA	NA
2067	scaffold_1	630052	631366	1314	130	yes	304542	+
2068	scaffold_1	634851	636141	1290	118	yes	4207	-
2069	scaffold_1	641081	642547	1466	124	yes	304546	-
2070	scaffold_1	643403	644507	1104	148	yes	304549	+
2071	scaffold_1	644731	644744	13	4	no	NA	NA
2072	scaffold_1	648331	649316	985	124	yes	304552	-
2073	scaffold_1	649721	650841	1120	132	yes	304552,386425	-,+
2074	scaffold_1	654277	655323	1046	112	yes	4265,304557	-,-
2075	scaffold_1	656780	657417	637	70	yes	419797	-
2076	scaffold_1	658690	660051	1361	151	no	NA	NA
2077	scaffold_1	665211	666691	1480	143	yes	412644	-
2078	scaffold_1	668487	669719	1232	161	no	NA	NA
2079	scaffold_1	673921	675067	1146	105	yes	386432	-
2080	scaffold_1	676678	677503	825	81	yes	239007	-
2081	scaffold_1	679108	679124	16	4	no	NA	NA
2082	scaffold_1	682293	682917	624	53	yes	4422	-
2083	scaffold_1	689945	690587	642	66	yes	386435	-
2084	scaffold_1	695450	696169	719	72	yes	386436	-
2085	scaffold_1	704802	704808	6	4	no	NA	NA
2086	scaffold_1	705050	705606	556	61	yes	386437	-
2087	scaffold_1	710845	711231	386	51	yes	239016	-
2088	scaffold_1	723198	723758	560	75	yes	304586	+
2089	scaffold_1	725006	725197	191	22	no	NA	NA
2090	scaffold_1	727212	727811	599	55	yes	304590	+
2091	scaffold_1	732971	734706	1735	219	yes	304593	-
2092	scaffold_1	738515	740181	1666	168	yes	304597	+
2093	scaffold_1	740302	740367	65	4	no	NA	NA
2094	scaffold_1	750672	751819	1147	88	yes	304602,419816	-,+
2095	scaffold_1	752260	753353	1093	86	yes	419816	+
2096	scaffold_1	756788	756810	22	6	no	NA	NA
2097	scaffold_1	771598	771660	62	10	no	NA	NA
2098	scaffold_1	771747	772317	570	63	no	NA	NA
2099	scaffold_1	777324	778191	867	134	yes	412667	+
2100	scaffold_1	787430	788987	1557	220	no	NA	NA
2101	scaffold_1	791731	792365	634	73	yes	4659	-
2102	scaffold_1	799857	801198	1341	162	yes	304622	+
2103	scaffold_1	802038	802984	946	86	yes	304623	+
2104	scaffold_1	813459	813480	21	6	no	NA	NA
2105	scaffold_1	841174	842082	908	107	no	NA	NA
2106	scaffold_1	845576	846265	689	91	no	NA	NA
2107	scaffold_1	847103	848406	1303	121	yes	304636	+
2108	scaffold_1	850255	851729	1474	147	yes	304640	+
2109	scaffold_1	878728	878761	33	10	yes	304647	-
2110	scaffold_1	878944	880234	1290	143	yes	304647	-
2111	scaffold_1	884086	885397	1311	109	yes	304649	-
2112	scaffold_1	890268	891336	1068	143	yes	4966	+
2113	scaffold_1	911830	913109	1279	123	yes	5006	-
2114	scaffold_1	914136	917058	2922	244	yes	304661,419838	-,+
2115	scaffold_1	918211	919245	1034	122	yes	304662	+
2116	scaffold_1	926219	927816	1597	146	yes	5069,5071	+,+
2117	scaffold_1	936216	936265	49	8	no	NA	NA
2118	scaffold_1	936379	937454	1075	115	no	NA	NA
2119	scaffold_1	954526	955449	923	56	yes	5092	+
2120	scaffold_1	955866	955877	11	4	no	NA	NA
2121	scaffold_1	979358	980279	921	96	yes	304671	-
2122	scaffold_1	980546	982066	1520	151	no	NA	NA
2123	scaffold_1	989930	990346	416	68	yes	304676	-
2124	scaffold_1	991494	992374	880	104	yes	304678	+
2125	scaffold_1	1002588	1003565	977	113	yes	239069	-
2126	scaffold_1	1004140	1005376	1236	96	yes	386487	+
2127	scaffold_1	1007063	1009182	2119	236	yes	226412	-
2128	scaffold_1	1010953	1012034	1081	111	yes	226413	+
2129	scaffold_1	1014411	1015506	1095	131	yes	304688	+
2130	scaffold_1	1019134	1020130	996	106	yes	386491	+
2131	scaffold_1	1027660	1028182	522	55	yes	304692	+
2132	scaffold_1	1028362	1028367	5	4	no	NA	NA
2133	scaffold_1	1044182	1045863	1681	164	yes	304693	+
2134	scaffold_1	1058459	1059670	1211	124	yes	5245	-
2135	scaffold_1	1068350	1069350	1000	133	no	NA	NA
2136	scaffold_1	1073198	1074154	956	112	yes	226424	-
2137	scaffold_1	1085293	1085999	706	42	yes	5279	+
2138	scaffold_1	1086256	1086414	158	5	no	NA	NA
2139	scaffold_1	1086579	1086592	13	6	no	NA	NA
2140	scaffold_1	1093506	1095816	2310	171	yes	5318	+
2141	scaffold_1	1101767	1103538	1771	165	no	NA	NA
2142	scaffold_1	1107877	1107887	10	5	no	NA	NA
2143	scaffold_1	1120933	1121036	103	15	no	NA	NA
2144	scaffold_1	1127264	1128599	1335	175	yes	304721	+
2145	scaffold_1	1135230	1136217	987	122	yes	6451	+
2146	scaffold_1	1154147	1154568	421	40	yes	304727	-
2147	scaffold_1	1157073	1157820	747	99	yes	239098	-
2148	scaffold_1	1158026	1158040	14	6	no	NA	NA
2149	scaffold_1	1159548	1160538	990	141	yes	304729	+
2150	scaffold_1	1174585	1175574	989	130	no	NA	NA
2151	scaffold_1	1193549	1194260	711	67	yes	239099	-
2152	scaffold_1	1198258	1199472	1214	135	yes	239104,288010	+,-
2153	scaffold_1	1199658	1200804	1146	175	yes	239104	+
2154	scaffold_1	1207927	1209029	1102	112	yes	226447	+
2155	scaffold_1	1214256	1215684	1428	141	yes	384626	+
2156	scaffold_1	1225706	1226840	1134	148	yes	304751	+
2157	scaffold_1	1229612	1230631	1019	82	yes	386519	+
2158	scaffold_1	1235341	1236535	1194	155	yes	419887	+
2159	scaffold_1	1243194	1244723	1529	209	yes	304760	-
2160	scaffold_1	1256301	1257342	1041	122	yes	304763	-
2161	scaffold_1	1259423	1259965	542	68	no	NA	NA
2162	scaffold_1	1260041	1260111	70	12	no	NA	NA
2163	scaffold_1	1261585	1262833	1248	123	no	NA	NA
2164	scaffold_1	1286011	1287226	1215	62	no	NA	NA
2165	scaffold_1	1295934	1298009	2075	175	yes	419895	+
2166	scaffold_1	1302761	1303200	439	28	yes	419896	+
2167	scaffold_1	1315619	1317353	1734	204	no	NA	NA
2168	scaffold_1	1318311	1319109	798	79	yes	304778	-
2169	scaffold_1	1322699	1323451	752	53	yes	288030	-
2170	scaffold_1	1323603	1323756	153	12	no	NA	NA
2171	scaffold_1	1324854	1325857	1003	128	no	NA	NA
2172	scaffold_1	1351037	1352523	1486	160	yes	419903	-
2173	scaffold_1	1358891	1359617	726	77	yes	304786,419904	+,-
2174	scaffold_1	1359917	1361028	1111	124	yes	304786	+
2175	scaffold_1	1363113	1364741	1628	162	yes	304788	+
2176	scaffold_1	1365666	1367097	1431	162	yes	304793,386539	-,-
2177	scaffold_1	1374651	1375089	438	29	yes	386541	-
2178	scaffold_1	1375539	1375570	31	5	yes	386541	-
2179	scaffold_1	1386922	1387672	750	51	yes	7001	+
2180	scaffold_1	1391965	1393392	1427	153	no	NA	NA
2181	scaffold_1	1411906	1412292	386	34	yes	419918	+
2182	scaffold_1	1412439	1412447	8	4	no	NA	NA
2183	scaffold_1	1425423	1426252	829	114	yes	419921	-
2184	scaffold_1	1434863	1435730	867	90	yes	304818	-
2185	scaffold_1	1438408	1439308	900	94	yes	304819	-
2186	scaffold_1	1471009	1471357	348	38	yes	419930	+
2187	scaffold_1	1484204	1485874	1670	241	yes	7124	-
2188	scaffold_1	1486711	1487884	1173	130	yes	419933	-
2189	scaffold_1	1488876	1490163	1287	135	yes	288065	+
2190	scaffold_1	1494862	1495793	931	110	yes	7184,304846	+,-
2191	scaffold_1	1496010	1497200	1190	188	yes	7184,304846	+,-
2192	scaffold_1	1499298	1500303	1005	107	yes	304851	-
2193	scaffold_1	1511436	1511957	521	30	yes	419938	-
2194	scaffold_1	1513468	1514113	645	72	yes	304862	+
2195	scaffold_1	1519070	1520099	1029	98	yes	304863	+
2196	scaffold_1	1525988	1527011	1023	124	yes	419942	-
2197	scaffold_1	1534522	1534640	118	18	yes	419943	-
2198	scaffold_1	1535147	1536561	1414	117	yes	419943,304868	-,-
2199	scaffold_1	1542797	1543777	980	105	yes	419945	-
2200	scaffold_1	1547052	1548395	1343	128	yes	412830	+
2201	scaffold_1	1553759	1553957	198	10	yes	304876	-
2202	scaffold_1	1555867	1557185	1318	122	yes	304878	+
2203	scaffold_1	1560354	1561503	1149	108	yes	304879	+
2204	scaffold_1	1565841	1567124	1283	164	yes	386583	+
2205	scaffold_1	1573322	1574645	1323	177	yes	304882	-
2206	scaffold_1	1575267	1576702	1435	178	yes	304883	+
2207	scaffold_1	1577265	1578798	1533	191	yes	304885	+
2208	scaffold_1	1585565	1586654	1089	118	yes	7540	-
2209	scaffold_1	1588195	1589145	950	93	yes	386587	+
2210	scaffold_1	1594972	1596482	1510	105	no	NA	NA
2211	scaffold_1	1601848	1603439	1591	182	yes	226512	-
2212	scaffold_1	1605477	1606710	1233	121	yes	304894	+
2213	scaffold_1	1612834	1612840	6	4	no	NA	NA
2214	scaffold_1	1613030	1614124	1094	136	yes	304897	-
2215	scaffold_1	1618127	1619816	1689	111	yes	304900	+
2216	scaffold_1	1625767	1626997	1230	119	yes	7702	+
2217	scaffold_1	1634900	1634987	87	4	no	NA	NA
2218	scaffold_1	1635124	1637040	1916	158	yes	412848	-
2219	scaffold_1	1647904	1648149	245	32	yes	386596	+
2220	scaffold_1	1662384	1663103	719	74	no	NA	NA
2221	scaffold_1	1667802	1669165	1363	156	no	NA	NA
2222	scaffold_1	1670856	1671866	1010	126	yes	304916,412855	+,-
2223	scaffold_1	1673139	1674007	868	93	yes	304920,419969	-,+
2224	scaffold_1	1676899	1677865	966	96	yes	304922	-
2225	scaffold_1	1681587	1681643	56	8	no	NA	NA
2226	scaffold_1	1681810	1682777	967	127	yes	7843,419971	+,-
2227	scaffold_1	1683008	1684182	1174	149	yes	7843,419971	+,-
2228	scaffold_1	1684694	1685949	1255	123	yes	304927	-
2229	scaffold_1	1686678	1687346	668	98	yes	304929	+
2230	scaffold_1	1692384	1693583	1199	121	yes	288113	-
2231	scaffold_1	1694919	1695958	1039	119	yes	212240	+
2232	scaffold_1	1702003	1703063	1060	131	yes	304937	-
2233	scaffold_1	1717793	1718747	954	127	yes	304941	+
2234	scaffold_1	1721398	1721402	4	4	yes	304944	-
2235	scaffold_1	1723103	1723129	26	8	no	NA	NA
2236	scaffold_1	1723272	1723329	57	6	no	NA	NA
2237	scaffold_1	1723428	1724767	1339	188	yes	412870	-
2238	scaffold_1	1741511	1743226	1715	190	yes	304953	-
2239	scaffold_1	1746915	1748014	1099	104	yes	304955	+
2240	scaffold_1	1756388	1757433	1045	104	yes	419988,419989	-,+
2241	scaffold_1	1758513	1759446	933	128	yes	304961	-
2242	scaffold_1	1767555	1768520	965	128	yes	386631	-
2243	scaffold_1	1768802	1769978	1176	125	yes	386631,304967	-,-
2244	scaffold_1	1772551	1773996	1445	161	yes	8091	-
2245	scaffold_1	1781051	1782083	1032	108	yes	304977	-
2246	scaffold_1	1786541	1787500	959	132	yes	304980	+
2247	scaffold_1	1788912	1790048	1136	123	yes	304982	+
2248	scaffold_1	1791691	1793185	1494	180	yes	304984	+
2249	scaffold_1	1798366	1799653	1287	210	no	NA	NA
2250	scaffold_1	1803595	1804411	816	78	yes	304988	-
2251	scaffold_1	1806417	1807049	632	84	yes	420000	-
2252	scaffold_1	1809708	1810987	1279	115	yes	304991	+
2253	scaffold_1	1815813	1816804	991	129	yes	304993	+
2254	scaffold_1	1817626	1818402	776	76	yes	304996	+
2255	scaffold_1	1818515	1818560	45	10	no	NA	NA
2256	scaffold_1	1822592	1823493	901	109	yes	304997	+
2257	scaffold_1	1823653	1823658	5	3	no	NA	NA
2258	scaffold_1	1824554	1827751	3197	350	yes	420006	-
2259	scaffold_1	1831860	1831930	70	16	no	NA	NA
2260	scaffold_1	1832039	1832658	619	76	yes	305005	-
2261	scaffold_1	1832952	1834410	1458	194	yes	305005,366948	-,+
2262	scaffold_1	1840032	1840677	645	62	yes	305011	-
2263	scaffold_1	1844938	1846456	1518	113	yes	412901	-
2264	scaffold_1	1849810	1850565	755	74	yes	386651	-
2265	scaffold_1	1853357	1854829	1472	166	yes	305014	-
2266	scaffold_1	1857241	1858158	917	104	yes	305015	-
2267	scaffold_1	1860672	1861837	1165	134	yes	386654	-
2268	scaffold_1	1865075	1866305	1230	134	yes	420015	-
2269	scaffold_1	1871476	1873295	1819	195	yes	305023	+
2270	scaffold_1	1874057	1874436	379	34	no	NA	NA
2271	scaffold_1	1881896	1883295	1399	154	no	NA	NA
2272	scaffold_1	1886472	1887567	1095	153	no	NA	NA
2273	scaffold_1	1890500	1891983	1483	153	yes	212133	+
2274	scaffold_1	1892171	1892377	206	6	no	NA	NA
2275	scaffold_1	1892948	1892971	23	3	no	NA	NA
2276	scaffold_1	1898241	1899380	1139	141	yes	386660	-
2277	scaffold_1	1905629	1907466	1837	181	yes	8572	-
2278	scaffold_1	1908968	1910158	1190	136	yes	8582,305043	-,+
2279	scaffold_1	1910383	1911371	988	111	yes	8582,305043	-,+
2280	scaffold_1	1914060	1915404	1344	147	yes	8623	+
2281	scaffold_1	1919455	1920863	1408	153	yes	212740	-
2282	scaffold_1	1922290	1923023	733	87	yes	305053	-
2283	scaffold_1	1923242	1924160	918	105	yes	305053,386668	-,-
2284	scaffold_1	1926883	1928293	1410	59	yes	226579	-
2285	scaffold_1	1973038	1975271	2233	225	yes	305057,420031	+,-
2286	scaffold_1	1992144	1993805	1661	147	no	NA	NA
2287	scaffold_1	1998997	1999842	845	128	yes	305078,386677	+,-
2288	scaffold_1	2000152	2001110	958	108	yes	305078,386677	+,-
2289	scaffold_1	2010789	2011805	1016	104	yes	420039	-
2290	scaffold_1	2016331	2017443	1112	91	no	NA	NA
2291	scaffold_1	2022921	2023905	984	96	yes	420041	-
2292	scaffold_1	2024765	2025858	1093	96	yes	412937	+
2293	scaffold_1	2028331	2028357	26	12	no	NA	NA
2294	scaffold_1	2028561	2029192	631	62	yes	366984	-
2295	scaffold_1	2033059	2034841	1782	149	yes	305090	+
2296	scaffold_1	2042340	2043789	1449	201	yes	420046	-
2297	scaffold_1	2044000	2044007	7	3	yes	420046	-
2298	scaffold_1	2049217	2049805	588	54	yes	212132	+
2299	scaffold_1	2050174	2050196	22	6	no	NA	NA
2300	scaffold_1	2052654	2053842	1188	142	no	NA	NA
2301	scaffold_1	2054754	2055903	1149	101	yes	386689	+
2302	scaffold_1	2067246	2068200	954	101	yes	305100	-
2303	scaffold_1	2069182	2070082	900	78	yes	384651	+
2304	scaffold_1	2075080	2076428	1348	162	yes	239259	-
2305	scaffold_1	2077714	2078931	1217	113	yes	305107	+
2306	scaffold_1	2082944	2084017	1073	113	yes	305108	-
2307	scaffold_1	2085246	2086545	1299	116	yes	305110	+
2308	scaffold_1	2088499	2089566	1067	129	yes	305113	+
2309	scaffold_1	2093745	2094733	988	119	yes	305115	-
2310	scaffold_1	2097627	2098998	1371	149	yes	386698	-
2311	scaffold_1	2099590	2101016	1426	176	yes	364815	+
2312	scaffold_1	2114176	2114968	792	56	no	NA	NA
2313	scaffold_1	2119696	2121906	2210	207	no	NA	NA
2314	scaffold_1	2125181	2126017	836	58	yes	412957	-
2315	scaffold_1	2128515	2128580	65	9	yes	305126	+
2316	scaffold_1	2129044	2130517	1473	197	yes	305126	+
2317	scaffold_1	2131508	2132715	1207	128	yes	212334	+
2318	scaffold_1	2134715	2135681	966	95	yes	305131	+
2319	scaffold_1	2135808	2135890	82	4	no	NA	NA
2320	scaffold_1	2139325	2139604	279	30	no	NA	NA
2321	scaffold_1	2147832	2148804	972	72	yes	9316,305136	+,+
2322	scaffold_1	2148942	2148958	16	6	yes	305136	+
2323	scaffold_1	2153631	2153643	12	5	no	NA	NA
2324	scaffold_1	2155038	2156559	1521	178	yes	412964	+
2325	scaffold_1	2169695	2170885	1190	126	yes	9351	-
2326	scaffold_1	2171543	2172820	1277	172	yes	239281	+
2327	scaffold_1	2176460	2177662	1202	145	yes	9399	+
2328	scaffold_1	2185558	2186066	508	52	yes	305152	-
2329	scaffold_1	2216530	2217378	848	94	yes	305165	-
2330	scaffold_1	2219918	2220315	397	34	yes	305166	+
2331	scaffold_1	2220429	2221045	616	70	yes	305166	+
2332	scaffold_1	2223486	2224268	782	97	yes	305167	-
2333	scaffold_1	2224822	2226054	1232	171	yes	305167,305170	-,+
2334	scaffold_1	2228056	2229366	1310	164	yes	412983	+
2335	scaffold_1	2235367	2236704	1337	184	yes	305174	-
2336	scaffold_1	2242190	2242419	229	18	yes	288240	-
2337	scaffold_1	2242550	2242555	5	4	yes	288240	-
2338	scaffold_1	2255393	2256144	751	88	yes	9544	-
2339	scaffold_1	2256453	2257176	723	104	yes	9544	-
2340	scaffold_1	2270220	2271733	1513	181	yes	288243	+
2341	scaffold_1	2276416	2277571	1155	148	yes	305194	+
2342	scaffold_1	2281919	2283121	1202	155	yes	305198	-
2343	scaffold_1	2283864	2284824	960	127	yes	239302	+
2344	scaffold_1	2284931	2284944	13	4	no	NA	NA
2345	scaffold_1	2288977	2290138	1161	124	yes	9745	+
2346	scaffold_1	2298821	2299664	843	86	yes	305203	+
2347	scaffold_1	2319292	2320563	1271	97	yes	420094	+
2348	scaffold_1	2342980	2344176	1196	118	yes	420097	+
2349	scaffold_1	2347029	2348190	1161	113	yes	305220	+
2350	scaffold_1	2350907	2351063	156	16	yes	305224	+
2351	scaffold_1	2351242	2351474	232	31	yes	305224	+
2352	scaffold_1	2353527	2354784	1257	125	yes	305226	+
2353	scaffold_1	2366191	2366773	582	42	yes	9880	-
2354	scaffold_1	2380356	2380997	641	70	yes	386750	-
2355	scaffold_1	2391859	2392586	727	52	yes	288268	+
2356	scaffold_1	2399605	2400917	1312	134	yes	305258	-
2357	scaffold_1	2405801	2406813	1012	104	yes	288270	+
2358	scaffold_1	2411998	2412171	173	23	no	NA	NA
2359	scaffold_1	2412286	2412504	218	34	no	NA	NA
2360	scaffold_1	2412740	2412786	46	14	no	NA	NA
2361	scaffold_1	2428635	2428647	12	6	yes	413025	+
2362	scaffold_1	2428865	2429686	821	108	yes	413025	+
2363	scaffold_1	2432164	2433512	1348	141	yes	212947	-
2364	scaffold_1	2452599	2453186	587	65	no	NA	NA
2365	scaffold_1	2462746	2463627	881	74	yes	386764	-
2366	scaffold_1	2465226	2465712	486	57	no	NA	NA
2367	scaffold_1	2465942	2467826	1884	254	no	NA	NA
2368	scaffold_1	2504069	2505406	1337	176	yes	420127	+
2369	scaffold_1	2513973	2514959	986	124	yes	305322	+
2370	scaffold_1	2517267	2517286	19	6	no	NA	NA
2371	scaffold_1	2517722	2518536	814	124	yes	305324,305326	-,+
2372	scaffold_1	2518837	2519611	774	78	yes	305324,305326	-,+
2373	scaffold_1	2523916	2523936	20	4	no	NA	NA
2374	scaffold_1	2524059	2525422	1363	178	yes	305329	-
2375	scaffold_1	2531019	2531943	924	90	yes	239360	-
2376	scaffold_1	2533895	2535426	1531	150	yes	305335	+
2377	scaffold_1	2539923	2540880	957	112	yes	305338	+
2378	scaffold_1	2543305	2544440	1135	89	yes	10286	+
2379	scaffold_1	2549837	2550816	979	145	yes	305343	-
2380	scaffold_1	2553440	2554501	1061	76	no	NA	NA
2381	scaffold_1	2563157	2563887	730	99	yes	420138	-
2382	scaffold_1	2564619	2566078	1459	191	yes	420138,305351	-,+
2383	scaffold_1	2574911	2574954	43	5	no	NA	NA
2384	scaffold_1	2575093	2575851	758	88	yes	10356	-
2385	scaffold_1	2577936	2578123	187	10	yes	305356	+
2386	scaffold_1	2578228	2579107	879	89	yes	305356,305357	+,+
2387	scaffold_1	2579411	2580551	1140	132	yes	305357	+
2388	scaffold_1	2583251	2584056	805	80	yes	305360	-
2389	scaffold_1	2585554	2586881	1327	151	yes	305363	+
2390	scaffold_1	2602420	2603354	934	81	yes	413065	-
2391	scaffold_1	2609007	2610041	1034	92	yes	413066	-
2392	scaffold_1	2616768	2618143	1375	168	yes	10499	-
2393	scaffold_1	2619935	2621031	1096	93	yes	226721	+
2394	scaffold_1	2621735	2623100	1365	161	yes	305379,420152	+,+
2395	scaffold_1	2628311	2630248	1937	191	yes	212724	+
2396	scaffold_1	2635923	2635990	67	6	no	NA	NA
2397	scaffold_1	2638109	2639242	1133	96	yes	305387	+
2398	scaffold_1	2643694	2643719	25	6	no	NA	NA
2399	scaffold_1	2643953	2646187	2234	213	yes	10609	-
2400	scaffold_1	2647096	2648022	926	106	yes	305392	+
2401	scaffold_1	2651694	2652763	1069	123	yes	305398	-
2402	scaffold_1	2653811	2654521	710	70	no	NA	NA
2403	scaffold_1	2659694	2660650	956	98	yes	305402	-
2404	scaffold_1	2663584	2664850	1266	126	yes	10726	+
2405	scaffold_1	2682302	2683542	1240	140	yes	288331	-
2406	scaffold_1	2689880	2691199	1319	145	yes	212617,420166	-,+
2407	scaffold_1	2691622	2692064	442	50	yes	420166	+
2408	scaffold_1	2692183	2692557	374	28	yes	305421	+
2409	scaffold_1	2692767	2693544	777	85	yes	305421	+
2410	scaffold_1	2698230	2699418	1188	159	yes	305427	-
2411	scaffold_1	2705377	2706527	1150	117	no	NA	NA
2412	scaffold_1	2716408	2717688	1280	86	yes	305437	-
2413	scaffold_1	2727927	2728783	856	78	no	NA	NA
2414	scaffold_1	2728918	2729096	178	8	no	NA	NA
2415	scaffold_1	2737352	2737770	418	33	yes	305449	+
2416	scaffold_1	2752086	2752622	536	40	yes	212537	+
2417	scaffold_1	2763217	2764335	1118	81	yes	305458	-
2418	scaffold_1	2777123	2777127	4	4	no	NA	NA
2419	scaffold_1	2780249	2781542	1293	110	yes	212276	-
2420	scaffold_1	2788184	2788837	653	45	no	NA	NA
2421	scaffold_1	2793607	2793626	19	4	no	NA	NA
2422	scaffold_1	2793745	2794911	1166	105	yes	305466	-
2423	scaffold_1	2796005	2796015	10	4	no	NA	NA
2424	scaffold_1	2796334	2797295	961	100	no	NA	NA
2425	scaffold_1	2798792	2800473	1681	192	yes	413106	+
2426	scaffold_1	2802485	2803640	1155	147	no	NA	NA
2427	scaffold_1	2818177	2819144	967	124	no	NA	NA
2428	scaffold_1	2826899	2827576	677	46	yes	305480	-
2429	scaffold_1	2840821	2842171	1350	166	yes	413114	-
2430	scaffold_1	2845796	2845811	15	6	yes	305485	-
2431	scaffold_1	2846010	2846364	354	33	yes	305485	-
2432	scaffold_1	2846519	2847867	1348	155	yes	305487	-
2433	scaffold_1	2848070	2849205	1135	114	yes	305487,305489	-,+
2434	scaffold_1	2849404	2850699	1295	178	yes	305489	+
2435	scaffold_1	2856569	2857734	1165	121	yes	386832	-
2436	scaffold_1	2862053	2863198	1145	117	yes	413121	+
2437	scaffold_1	2864743	2866109	1366	148	no	NA	NA
2438	scaffold_1	2866222	2866298	76	14	no	NA	NA
2439	scaffold_1	2866415	2866437	22	5	no	NA	NA
2440	scaffold_1	2872297	2872330	33	10	no	NA	NA
2441	scaffold_1	2872432	2873713	1281	109	yes	239429	-
2442	scaffold_1	2875409	2876255	846	58	yes	386838	+
2443	scaffold_1	2879579	2880395	816	76	yes	305513	-
2444	scaffold_1	2881832	2883189	1357	174	yes	386840	+
2445	scaffold_1	2887732	2888952	1220	170	yes	305521	+
2446	scaffold_1	2894925	2895733	808	111	yes	226776	-
2447	scaffold_1	2895838	2895988	150	10	yes	226776	-
2448	scaffold_1	2902009	2902923	914	78	yes	212562	+
2449	scaffold_1	2906486	2907342	856	84	yes	305525	-
2450	scaffold_1	2909444	2910422	978	118	yes	226784	+
2451	scaffold_1	2918482	2919463	981	134	yes	305531	-
2452	scaffold_1	2928847	2929710	863	100	yes	11453,305536	-,+
2453	scaffold_1	2929815	2929836	21	8	no	NA	NA
2454	scaffold_1	2939919	2941015	1096	129	yes	305542	-
2455	scaffold_1	2942194	2943646	1452	161	yes	305545	+
2456	scaffold_1	2947525	2947625	100	19	no	NA	NA
2457	scaffold_1	2947812	2948420	608	65	yes	11524	-
2458	scaffold_1	2948809	2950417	1608	182	yes	11524	-
2459	scaffold_1	2961643	2962109	466	65	yes	305548	+
2460	scaffold_1	2969455	2970646	1191	131	yes	386862	-
2461	scaffold_1	2971239	2972166	927	104	yes	305556	+
2462	scaffold_1	2978467	2979229	762	51	yes	305558	+
2463	scaffold_1	2979382	2979453	71	4	no	NA	NA
2464	scaffold_1	2986138	2987037	899	107	yes	305560	+
2465	scaffold_1	2992459	2993710	1251	133	yes	239468	-
2466	scaffold_1	2995165	2995211	46	4	no	NA	NA
2467	scaffold_1	2997153	2998238	1085	72	yes	305565	+
2468	scaffold_1	2998546	2998567	21	6	no	NA	NA
2469	scaffold_1	3001030	3001070	40	10	no	NA	NA
2470	scaffold_1	3003892	3003909	17	6	no	NA	NA
2471	scaffold_1	3006648	3008182	1534	138	yes	305573	+
2472	scaffold_1	3014475	3014695	220	12	yes	413157	-
2473	scaffold_1	3015146	3015753	607	67	no	NA	NA
2474	scaffold_1	3038454	3039452	998	132	no	NA	NA
2475	scaffold_1	3039656	3039674	18	8	no	NA	NA
2476	scaffold_1	3040886	3040951	65	7	yes	11820	-
2477	scaffold_1	3041023	3041312	289	12	yes	11820	-
2478	scaffold_1	3047908	3049083	1175	106	yes	413162	+
2479	scaffold_1	3069838	3070951	1113	96	yes	413167	+
2480	scaffold_1	3080484	3080887	403	28	yes	239477	+
2481	scaffold_1	3090990	3092129	1139	69	no	NA	NA
2482	scaffold_1	3095442	3095454	12	4	no	NA	NA
2483	scaffold_1	3100000	3101118	1118	175	yes	11906	+
2484	scaffold_1	3108343	3108634	291	20	yes	11932	+
2485	scaffold_1	3141476	3141702	226	6	yes	420240	-
2486	scaffold_1	3141914	3141921	7	4	no	NA	NA
2487	scaffold_1	3162063	3163656	1593	165	yes	12024	-
2488	scaffold_1	3163832	3164812	980	125	yes	12024	-
2489	scaffold_1	3171855	3173061	1206	106	no	NA	NA
2490	scaffold_1	3186748	3187604	856	91	yes	305645	-
2491	scaffold_1	3188648	3189298	650	70	no	NA	NA
2492	scaffold_1	3192047	3193566	1519	156	yes	212363	-
2493	scaffold_1	3206367	3208018	1651	120	yes	288435	+
2494	scaffold_1	3211535	3212672	1137	146	yes	12164	+
2495	scaffold_1	3215702	3215784	82	4	no	NA	NA
2496	scaffold_1	3215921	3217128	1207	138	yes	305656	-
2497	scaffold_1	3217848	3218397	549	79	yes	305658	+
2498	scaffold_1	3220208	3220217	9	4	yes	305660	+
2499	scaffold_1	3222189	3222953	764	109	yes	305661	+
2500	scaffold_1	3228632	3229635	1003	115	yes	305665	-
2501	scaffold_1	3241985	3243146	1161	116	yes	12233	-
2502	scaffold_1	3243786	3244898	1112	118	yes	386905	+
2503	scaffold_1	3248355	3249495	1140	118	yes	413197	-
2504	scaffold_1	3251861	3252397	536	57	no	NA	NA
2505	scaffold_1	3254241	3255890	1649	174	yes	305678	+
2506	scaffold_1	3260960	3262525	1565	188	yes	305680	-
2507	scaffold_1	3263382	3264911	1529	168	yes	305684	+
2508	scaffold_1	3268890	3269715	825	112	yes	305688	-
2509	scaffold_1	3272056	3273023	967	128	yes	305694	-
2510	scaffold_1	3276086	3277149	1063	149	yes	305696	-
2511	scaffold_1	3280251	3281634	1383	200	yes	364857	-
2512	scaffold_1	3282539	3283698	1159	92	yes	367140	+
2513	scaffold_1	3286074	3287071	997	87	yes	305703	+
2514	scaffold_1	3288458	3289667	1209	137	no	NA	NA
2515	scaffold_1	3291434	3292427	993	92	no	NA	NA
2516	scaffold_1	3298801	3298921	120	12	no	NA	NA
2517	scaffold_1	3299544	3300549	1005	78	no	NA	NA
2518	scaffold_1	3302049	3303308	1259	85	yes	386918	+
2519	scaffold_1	3308521	3309356	835	52	yes	420265	-
2520	scaffold_1	3316155	3317404	1249	132	yes	420266	-
2521	scaffold_1	3326213	3326769	556	58	yes	386920	+
2522	scaffold_1	3339231	3340648	1417	178	yes	305717	+
2523	scaffold_1	3377309	3377417	108	22	yes	386928	+
2524	scaffold_1	3384588	3385053	465	52	yes	239550	+
2525	scaffold_1	3387099	3388270	1171	115	yes	12577	+
2526	scaffold_1	3397258	3397285	27	6	no	NA	NA
2527	scaffold_1	3397409	3398625	1216	86	yes	305731	-
2528	scaffold_1	3415175	3416307	1132	102	yes	212931	-
2529	scaffold_1	3427301	3428562	1261	79	yes	12632	+
2530	scaffold_1	3432891	3433905	1014	105	yes	305736	+
2531	scaffold_1	3436946	3438147	1201	105	yes	212987	+
2532	scaffold_1	3443862	3446248	2386	321	yes	288482	+
2533	scaffold_1	3446299	3446386	87	16	no	NA	NA
2534	scaffold_1	3446435	3446783	348	55	no	NA	NA
2535	scaffold_1	3457314	3458196	882	54	yes	12685	+
2536	scaffold_1	3464080	3464623	543	74	yes	288484	-
2537	scaffold_1	3474433	3474974	541	28	yes	12705	-
2538	scaffold_1	3483325	3484313	988	89	no	NA	NA
2539	scaffold_1	3489426	3490535	1109	147	yes	305753,305755	-,+
2540	scaffold_1	3490818	3491899	1081	115	yes	305753,305755	-,+
2541	scaffold_1	3497026	3497987	961	62	yes	413245	-
2542	scaffold_1	3503024	3504216	1192	99	yes	413246	+
2543	scaffold_1	3507847	3509010	1163	166	yes	305764	+
2544	scaffold_1	3513077	3514182	1105	141	yes	305767	+
2545	scaffold_1	3518903	3519538	635	66	no	NA	NA
2546	scaffold_1	3528171	3529150	979	117	yes	420296	-
2547	scaffold_1	3533959	3535135	1176	121	yes	305780,367176	+,-
2548	scaffold_1	3535396	3536585	1189	159	yes	305780,367176	+,-
2549	scaffold_1	3566429	3567569	1140	137	yes	226915,420302	-,+
2550	scaffold_1	3568000	3568945	945	127	yes	226915,420302	-,+
2551	scaffold_1	3574166	3575590	1424	132	yes	413259	+
2552	scaffold_1	3585963	3587433	1470	110	yes	413261	-
2553	scaffold_1	3596968	3598041	1073	110	yes	413264	-
2554	scaffold_1	3601999	3603361	1362	103	yes	239580	-
2555	scaffold_1	3606051	3607064	1013	98	yes	305811	-
2556	scaffold_1	3608902	3610336	1434	141	yes	13178	-
2557	scaffold_1	3612430	3612436	6	4	no	NA	NA
2558	scaffold_1	3612631	3614063	1432	146	no	NA	NA
2559	scaffold_1	3617030	3618553	1523	117	yes	413269	+
2560	scaffold_1	3621620	3622411	791	78	no	NA	NA
2561	scaffold_1	3626962	3627930	968	114	yes	13268	+
2562	scaffold_1	3640971	3642102	1131	150	yes	367186	-
2563	scaffold_1	3643117	3644044	927	117	yes	386970	+
2564	scaffold_1	3644222	3644269	47	10	yes	386970	+
2565	scaffold_1	3647476	3648590	1114	152	yes	305834	+
2566	scaffold_1	3658343	3658797	454	44	no	NA	NA
2567	scaffold_1	3659212	3659886	674	56	yes	420320	+
2568	scaffold_1	3670746	3671028	282	24	yes	305851	+
2569	scaffold_1	3673317	3673896	579	56	yes	420323	+
2570	scaffold_1	3675157	3675781	624	61	yes	13436	+
2571	scaffold_1	3677626	3678760	1134	136	yes	386978	+
2572	scaffold_1	3684076	3685022	946	106	yes	13450,305858	-,+
2573	scaffold_1	3685210	3687247	2037	227	yes	13450,305858	-,+
2574	scaffold_1	3702023	3703207	1184	122	yes	305866	+
2575	scaffold_1	3707142	3707262	120	11	no	NA	NA
2576	scaffold_1	3707349	3707756	407	34	yes	305867	-
2577	scaffold_1	3724741	3725132	391	70	yes	305873	-
2578	scaffold_1	3727633	3729172	1539	187	yes	305876	-
2579	scaffold_1	3731684	3732735	1051	93	yes	288539	+
2580	scaffold_1	3735281	3736584	1303	137	yes	305884	-
2581	scaffold_1	3738306	3739401	1095	80	yes	305887	-
2582	scaffold_1	3744879	3746041	1162	128	no	NA	NA
2583	scaffold_1	3749698	3750816	1118	94	yes	305893	-
2584	scaffold_1	3754331	3755510	1179	119	yes	305896	+
2585	scaffold_1	3759139	3759904	765	53	no	NA	NA
2586	scaffold_1	3763361	3764340	979	120	yes	305897	-
2587	scaffold_1	3768068	3768975	907	85	yes	305898	+
2588	scaffold_1	3770571	3770839	268	36	no	NA	NA
2589	scaffold_1	3772083	3772699	616	54	yes	305909	-
2590	scaffold_1	3774081	3774584	503	68	yes	386999	-
2591	scaffold_1	3776048	3777572	1524	169	yes	413308,413309	-,-
2592	scaffold_1	3791510	3791893	383	60	yes	288553	-
2593	scaffold_1	3794614	3794881	267	28	no	NA	NA
2594	scaffold_1	3811857	3812815	958	78	yes	305918	+
2595	scaffold_1	3815037	3816179	1142	140	no	NA	NA
2596	scaffold_1	3821129	3822350	1221	137	no	NA	NA
2597	scaffold_1	3828053	3829224	1171	153	yes	413319	+
2598	scaffold_1	3833576	3834550	974	96	yes	420349	+
2599	scaffold_1	3860658	3861257	599	99	yes	288564	+
2600	scaffold_1	3872354	3873403	1049	99	yes	13849,305938	-,+
2601	scaffold_1	3873869	3874769	900	87	yes	13849,305938	-,+
2602	scaffold_1	3876852	3876911	59	21	no	NA	NA
2603	scaffold_1	3886962	3887291	329	43	yes	13869	+
2604	scaffold_1	3901654	3903133	1479	126	yes	212871	-
2605	scaffold_1	3906070	3907441	1371	147	yes	305955	-
2606	scaffold_1	3915909	3917289	1380	95	yes	305958	-
2607	scaffold_1	3919839	3920433	594	57	yes	305961,305963	-,+
2608	scaffold_1	3920697	3921941	1244	142	yes	305961,305963	-,+
2609	scaffold_1	3922461	3922473	12	3	no	NA	NA
2610	scaffold_1	3924998	3925594	596	70	yes	239647	-
2611	scaffold_1	3931472	3932663	1191	141	yes	305969	+
2612	scaffold_1	3939280	3940319	1039	77	yes	212900	-
2613	scaffold_1	3977728	3978929	1201	115	yes	305982	+
2614	scaffold_1	4009847	4009905	58	10	no	NA	NA
2615	scaffold_1	4010033	4010038	5	4	no	NA	NA
2616	scaffold_1	4010178	4010580	402	38	no	NA	NA
2617	scaffold_1	4034800	4036569	1769	221	yes	212242	-
2618	scaffold_1	4045490	4046358	868	94	yes	387034	+
2619	scaffold_1	4054406	4056014	1608	153	yes	420384	+
2620	scaffold_1	4060014	4060822	808	90	no	NA	NA
2621	scaffold_1	4063877	4065395	1518	162	yes	212191,413377	-,+
2622	scaffold_1	4077286	4079521	2235	217	yes	306010	-
2623	scaffold_1	4082728	4083110	382	26	yes	14227	+
2624	scaffold_1	4083532	4083608	76	16	no	NA	NA
2625	scaffold_1	4085872	4086128	256	35	yes	306014	+
2626	scaffold_1	4086212	4087364	1152	119	yes	306014	+
2627	scaffold_1	4093002	4094151	1149	113	yes	420391	-
2628	scaffold_1	4098703	4099104	401	41	yes	420392	-
2629	scaffold_1	4111496	4112663	1167	107	yes	306018	-
2630	scaffold_1	4117139	4117897	758	55	yes	420394	+
2631	scaffold_1	4128714	4130074	1360	180	yes	306024	+
2632	scaffold_1	4133090	4134168	1078	134	yes	14329	-
2633	scaffold_1	4135520	4136493	973	105	yes	306029	+
2634	scaffold_1	4142653	4144176	1523	152	yes	306031	-
2635	scaffold_1	4154523	4156480	1957	142	yes	306036	+
2636	scaffold_1	4158684	4159961	1277	111	yes	420402	+
2637	scaffold_1	4163141	4164409	1268	119	yes	306039	-
2638	scaffold_1	4166469	4167929	1460	143	no	NA	NA
2639	scaffold_1	4170370	4172066	1696	182	yes	387054	+
2640	scaffold_1	4178629	4179579	950	87	yes	420407	-
2641	scaffold_1	4190324	4190944	620	46	yes	306048	-
2642	scaffold_1	4211086	4212619	1533	128	yes	413410	+
2643	scaffold_1	4232323	4233097	774	92	no	NA	NA
2644	scaffold_1	4238159	4240346	2187	188	yes	420413	+
2645	scaffold_1	4253718	4254941	1223	145	yes	212861,306063	-,+
2646	scaffold_1	4255224	4256299	1075	116	yes	306063,420415	+,+
2647	scaffold_1	4256774	4257777	1003	128	yes	420415	+
2648	scaffold_1	4265498	4266622	1124	86	yes	387065	-
2649	scaffold_1	4271527	4271534	7	4	no	NA	NA
2650	scaffold_1	4272503	4273792	1289	153	yes	306071	+
2651	scaffold_1	4329308	4330571	1263	164	yes	387071	-
2652	scaffold_1	4333888	4334665	777	90	yes	306092	-
2653	scaffold_1	4334909	4335744	835	109	yes	306092	-
2654	scaffold_1	4347205	4348422	1217	100	yes	14792	-
2655	scaffold_1	4356748	4357691	943	141	yes	306111	-
2656	scaffold_1	4359361	4360138	777	71	yes	387080	-
2657	scaffold_1	4362147	4362790	643	64	yes	413432	-
2658	scaffold_1	4364971	4365661	690	78	yes	306115	-
2659	scaffold_1	4366983	4368417	1434	138	yes	413434	+
2660	scaffold_1	4374574	4376049	1475	114	yes	420431	+
2661	scaffold_1	4385883	4387076	1193	148	yes	306128,306132	-,+
2662	scaffold_1	4391523	4394687	3164	383	yes	387089,413439	+,-
2663	scaffold_1	4394884	4395815	931	140	yes	387089,413439	+,-
2664	scaffold_1	4401014	4402421	1407	163	yes	413441	-
2665	scaffold_1	4428430	4429622	1192	142	yes	306143	+
2666	scaffold_18	14768	14775	7	4	yes	218054	-
2667	scaffold_18	32234	33745	1511	173	yes	416948	+
2668	scaffold_18	35568	35575	7	3	no	NA	NA
2669	scaffold_18	38688	40246	1558	120	yes	317470	+
2670	scaffold_18	40416	40435	19	4	no	NA	NA
2671	scaffold_18	52733	53642	909	112	no	NA	NA
2672	scaffold_18	55403	56637	1234	120	yes	424823	+
2673	scaffold_18	69625	70539	914	66	yes	317480	+
2674	scaffold_18	74473	75213	740	94	yes	365639	+
2675	scaffold_18	78658	79757	1099	139	yes	293888	+
2676	scaffold_18	91587	92606	1019	113	yes	416963,424830	+,-
2677	scaffold_18	112067	112491	424	35	yes	317492	+
2678	scaffold_18	137045	138421	1376	131	yes	317504	+
2679	scaffold_18	138596	139614	1018	113	yes	317504	+
2680	scaffold_18	155933	157153	1220	136	no	NA	NA
2681	scaffold_18	158229	159413	1184	131	yes	424840	-
2682	scaffold_18	161173	162621	1448	154	yes	317520	-
2683	scaffold_18	163158	164215	1057	134	yes	317520,317522	-,+
2684	scaffold_18	168683	169754	1071	113	yes	244013	-
2685	scaffold_18	170071	171738	1667	204	yes	416981	+
2686	scaffold_18	176822	176867	45	3	yes	370731	-
2687	scaffold_18	177019	178137	1118	124	yes	370731	-
2688	scaffold_18	183219	183592	373	25	yes	231486	-
2689	scaffold_18	190525	191685	1160	148	yes	317530	+
2690	scaffold_18	195711	196864	1153	121	yes	317531	+
2691	scaffold_18	201806	202795	989	126	yes	317532	+
2692	scaffold_18	212439	213333	894	86	yes	416989	+
2693	scaffold_18	215243	215992	749	43	yes	317536	+
2694	scaffold_18	217779	218690	911	66	yes	424853	+
2695	scaffold_18	225780	227136	1356	119	yes	370739	-
2696	scaffold_18	230720	231812	1092	108	yes	317543	+
2697	scaffold_18	237354	238742	1388	200	yes	391499	+
2698	scaffold_18	241149	242559	1410	140	yes	424856	+
2699	scaffold_18	242825	242832	7	4	no	NA	NA
2700	scaffold_18	251636	252538	902	122	yes	52339	-
2701	scaffold_18	253191	254167	976	116	yes	317558	+
2702	scaffold_18	258553	260038	1485	159	yes	317561	-
2703	scaffold_18	263000	263806	806	72	yes	317565	+
2704	scaffold_18	265846	266930	1084	142	yes	417000	+
2705	scaffold_18	276801	278270	1469	135	yes	231512	+
2706	scaffold_18	287378	288479	1101	93	no	NA	NA
2707	scaffold_18	296703	296821	118	24	yes	317580	+
2708	scaffold_18	296910	296930	20	6	yes	317580	+
2709	scaffold_18	298274	298345	71	13	yes	317581	+
2710	scaffold_18	299656	300689	1033	95	yes	317582	+
2711	scaffold_18	334987	335058	71	4	yes	244049	+
2712	scaffold_18	337505	338498	993	135	yes	317584	-
2713	scaffold_18	344489	344930	441	57	yes	391515	+
2714	scaffold_18	347008	348134	1126	118	yes	317590	+
2715	scaffold_18	348360	348371	11	3	no	NA	NA
2716	scaffold_18	352243	353762	1519	153	yes	417024	+
2717	scaffold_18	368136	369513	1377	143	yes	317600	+
2718	scaffold_18	372377	373715	1338	177	yes	317601	+
2719	scaffold_18	443323	444765	1442	171	no	NA	NA
2720	scaffold_18	461091	461854	763	105	yes	52800	-
2721	scaffold_18	509334	509811	477	51	yes	231579	-
2722	scaffold_18	517206	518791	1585	205	yes	424894	-
2723	scaffold_18	525923	526416	493	51	yes	317828	+
2724	scaffold_18	526780	526787	7	4	no	NA	NA
2725	scaffold_18	531130	531997	867	113	yes	391539	-
2726	scaffold_18	557685	558245	560	59	yes	317839	-
2727	scaffold_18	560412	560778	366	36	yes	317840	-
2728	scaffold_18	588531	589624	1093	131	no	NA	NA
2729	scaffold_18	594426	594446	20	5	yes	424911	-
2730	scaffold_18	598543	599396	853	98	yes	52974	+
2731	scaffold_18	615784	616246	462	60	yes	293989	+
2732	scaffold_18	658405	659095	690	75	no	NA	NA
2733	scaffold_18	659208	659574	366	45	yes	391561	-
2734	scaffold_18	660621	661428	807	80	yes	391562	+
2735	scaffold_18	663775	664715	940	95	yes	317879	+
2736	scaffold_18	675311	675853	542	62	yes	317887	-
2737	scaffold_18	677446	677695	249	50	yes	317888	+
2738	scaffold_18	677783	678573	790	93	yes	317888	+
2739	scaffold_18	680606	680676	70	14	no	NA	NA
2740	scaffold_18	680777	681500	723	107	yes	317889	-
2741	scaffold_18	681716	682782	1066	150	yes	317889	-
2742	scaffold_18	690026	690055	29	6	no	NA	NA
2743	scaffold_18	690266	691184	918	84	yes	317895	-
2744	scaffold_18	691307	691322	15	4	yes	317895	-
2745	scaffold_18	700402	700986	584	81	no	NA	NA
2746	scaffold_18	701203	701251	48	15	no	NA	NA
2747	scaffold_18	705077	706498	1421	176	yes	317897	-
2748	scaffold_18	717791	718753	962	92	yes	391576	-
2749	scaffold_18	731034	731054	20	5	no	NA	NA
2750	scaffold_18	731218	731226	8	4	yes	424937	-
2751	scaffold_18	731457	731646	189	15	yes	424937	-
2752	scaffold_18	734640	735510	870	105	yes	294017	+
2753	scaffold_18	738965	739800	835	70	yes	424939	-
2754	scaffold_18	747960	748217	257	28	yes	53198	-
2755	scaffold_18	757870	758753	883	76	yes	424943	+
2756	scaffold_18	770976	770984	8	4	no	NA	NA
2757	scaffold_18	772119	772660	541	54	yes	424945	+
2758	scaffold_18	777627	778828	1201	128	yes	53241	+
2759	scaffold_18	789076	789311	235	26	yes	424947	+
2760	scaffold_18	794045	794114	69	12	yes	217950	-
2761	scaffold_18	794216	794424	208	20	yes	217950	-
2762	scaffold_18	797492	797501	9	4	yes	317933	-
2763	scaffold_18	797682	797700	18	8	yes	317933	-
2764	scaffold_18	799545	800853	1308	143	yes	424950	-
2765	scaffold_18	802399	802424	25	10	no	NA	NA
2766	scaffold_18	803830	804364	534	62	yes	317936	-
2767	scaffold_18	808770	810040	1270	128	yes	53267	+
2768	scaffold_18	812394	812400	6	4	no	NA	NA
2769	scaffold_18	812780	812850	70	14	yes	424954	-
2770	scaffold_18	833743	834036	293	30	yes	317944	-
2771	scaffold_18	836107	837588	1481	144	yes	317947	+
2772	scaffold_18	854294	855344	1050	125	yes	424961	+
2773	scaffold_18	855627	856982	1355	178	yes	424961	+
2774	scaffold_18	865345	865354	9	4	yes	294050	+
2775	scaffold_18	865712	865767	55	10	yes	294050	+
2776	scaffold_18	865878	865909	31	8	no	NA	NA
2777	scaffold_18	889609	890832	1223	160	yes	391609	-
2778	scaffold_18	901522	902793	1271	135	yes	317962	+
2779	scaffold_18	913423	916873	3450	284	yes	294061,417157	-,-
2780	scaffold_18	918568	918743	175	26	yes	391615	-
2781	scaffold_18	929324	930372	1048	137	no	NA	NA
2782	scaffold_18	930476	930503	27	8	yes	417162	-
2783	scaffold_18	934661	935379	718	81	yes	317977	+
2784	scaffold_18	939539	940720	1181	96	yes	294067	+
2785	scaffold_18	943978	944444	466	50	no	NA	NA
2786	scaffold_18	944639	944745	106	7	no	NA	NA
2787	scaffold_18	996993	997026	33	10	yes	424979	+
2788	scaffold_18	997237	998378	1141	165	yes	424979	+
2789	scaffold_18	1004095	1004146	51	16	no	NA	NA
2790	scaffold_18	1013383	1014264	881	109	yes	318002	-
2791	scaffold_18	1020543	1022102	1559	216	yes	424983	+
2792	scaffold_18	1039257	1039456	199	22	no	NA	NA
2793	scaffold_18	1041510	1042779	1269	191	no	NA	NA
2794	scaffold_18	1042862	1042869	7	4	no	NA	NA
2795	scaffold_18	1047012	1048002	990	153	yes	294082	+
2796	scaffold_18	1048099	1048268	169	14	no	NA	NA
2797	scaffold_18	1156010	1157067	1057	154	no	NA	NA
2798	scaffold_18	1170518	1170534	16	3	no	NA	NA
2799	scaffold_18	1178105	1179550	1445	161	yes	391638	-
2800	scaffold_17	1649	2298	649	20	yes	293622	-
2801	scaffold_17	7852	8850	998	116	yes	424613	-
2802	scaffold_17	9363	10548	1185	110	yes	424614	-
2803	scaffold_17	11967	13645	1678	182	yes	316881	+
2804	scaffold_17	21676	23042	1366	149	no	NA	NA
2805	scaffold_17	32866	33890	1024	104	yes	231242	+
2806	scaffold_17	38749	39773	1024	115	yes	48099,293629	-,-
2807	scaffold_17	42622	43711	1089	108	yes	316893	-
2808	scaffold_17	56249	57383	1134	123	yes	316901	-
2809	scaffold_17	59391	59399	8	4	no	NA	NA
2810	scaffold_17	67940	68962	1022	138	yes	316909,424627	-,+
2811	scaffold_17	69203	70291	1088	133	yes	316909,424627	-,+
2812	scaffold_17	81750	81758	8	4	no	NA	NA
2813	scaffold_17	82020	83339	1319	135	no	NA	NA
2814	scaffold_17	84126	85100	974	115	yes	293640,391252	+,-
2815	scaffold_17	85257	85455	198	16	yes	293640	+
2816	scaffold_17	93970	94882	912	84	yes	48407	-
2817	scaffold_17	97605	98966	1361	143	yes	365590	+
2818	scaffold_17	109298	109307	9	4	no	NA	NA
2819	scaffold_17	109565	110683	1118	149	yes	424632	-
2820	scaffold_17	111372	112480	1108	149	yes	48435	+
2821	scaffold_17	116739	118108	1369	173	yes	316932	-
2822	scaffold_17	118750	119949	1199	147	yes	316935	+
2823	scaffold_17	122786	123447	661	61	yes	316940	+
2824	scaffold_17	126295	127933	1638	184	yes	316942	+
2825	scaffold_17	134773	135953	1180	151	yes	231260	+
2826	scaffold_17	138352	139859	1507	170	yes	293651	+
2827	scaffold_17	145907	145913	6	4	no	NA	NA
2828	scaffold_17	154447	155398	951	97	yes	391265	+
2829	scaffold_17	158854	159808	954	138	yes	424641	-
2830	scaffold_17	161437	162587	1150	107	yes	316960	-
2831	scaffold_17	165986	166514	528	72	no	NA	NA
2832	scaffold_17	167181	167823	642	48	yes	316962	+
2833	scaffold_17	170622	173594	2972	313	yes	231265	+
2834	scaffold_17	173803	175367	1564	141	yes	316970	-
2835	scaffold_17	176990	178322	1332	113	yes	293658	+
2836	scaffold_17	185561	187305	1744	187	yes	316975,316979	+,+
2837	scaffold_17	187617	188768	1151	192	yes	316979	+
2838	scaffold_17	190713	192016	1303	100	yes	385381	+
2839	scaffold_17	195717	196870	1153	91	yes	316982	-
2840	scaffold_17	197305	197313	8	4	yes	316982	-
2841	scaffold_17	197658	197671	13	5	no	NA	NA
2842	scaffold_17	199142	200605	1463	214	yes	316983	+
2843	scaffold_17	211845	212958	1113	141	yes	48723	-
2844	scaffold_17	224602	224747	145	4	yes	412125	+
2845	scaffold_17	224939	224975	36	4	yes	412125	+
2846	scaffold_17	228895	230081	1186	113	yes	243806	-
2847	scaffold_17	233179	234433	1254	137	yes	293672	-
2848	scaffold_17	254775	256843	2068	173	yes	293676	-
2849	scaffold_17	263860	263872	12	5	no	NA	NA
2850	scaffold_17	264084	265073	989	130	yes	317008	-
2851	scaffold_17	269139	269594	455	40	no	NA	NA
2852	scaffold_17	269835	269840	5	4	no	NA	NA
2853	scaffold_17	275524	276399	875	144	yes	217698,391293	-,+
2854	scaffold_17	276597	277544	947	95	yes	217698,391293	-,+
2855	scaffold_17	290844	292026	1182	173	yes	317020	-
2856	scaffold_17	299468	300385	917	107	yes	317023	-
2857	scaffold_17	301030	302645	1615	165	yes	217658	+
2858	scaffold_17	308444	309730	1286	164	yes	424670	+
2859	scaffold_17	315424	316566	1142	85	yes	293692	-
2860	scaffold_17	318980	320136	1156	127	yes	424672	+
2861	scaffold_17	328701	329672	971	143	yes	317036	+
2862	scaffold_17	335924	337060	1136	141	yes	424675	+
2863	scaffold_17	344836	345788	952	104	yes	412148	-
2864	scaffold_17	347705	348979	1274	144	yes	49198,317052	-,+
2865	scaffold_17	353133	353199	66	16	yes	424679	+
2866	scaffold_17	353316	354562	1246	166	yes	424679	+
2867	scaffold_17	359079	360378	1299	130	yes	317059	+
2868	scaffold_17	362923	363734	811	82	yes	391314	+
2869	scaffold_17	368780	369558	778	62	yes	317062	+
2870	scaffold_17	374929	375848	919	60	no	NA	NA
2871	scaffold_17	378286	378308	22	8	yes	317066	+
2872	scaffold_17	378607	379528	921	81	yes	317066	+
2873	scaffold_17	383081	384031	950	100	no	NA	NA
2874	scaffold_17	386857	387962	1105	149	yes	317073,317080	-,+
2875	scaffold_17	388368	389146	778	76	yes	317073,317080	-,+
2876	scaffold_17	394110	394932	822	80	yes	317087	-
2877	scaffold_17	402884	404085	1201	135	no	NA	NA
2878	scaffold_17	411166	412671	1505	142	no	NA	NA
2879	scaffold_17	418383	419641	1258	124	yes	49555	+
2880	scaffold_17	421733	422907	1174	122	yes	370497	+
2881	scaffold_17	441984	443458	1474	165	yes	293722	+
2882	scaffold_17	446286	447202	916	87	yes	317108	+
2883	scaffold_17	453425	454600	1175	157	yes	391333	-
2884	scaffold_17	456314	456382	68	18	yes	49660	+
2885	scaffold_17	456602	456787	185	17	yes	49660	+
2886	scaffold_17	460888	462178	1290	137	yes	317114	-
2887	scaffold_17	480143	481639	1496	160	no	NA	NA
2888	scaffold_17	497134	497560	426	62	yes	391338	+
2889	scaffold_17	501299	502300	1001	116	yes	317138	+
2890	scaffold_17	506345	507219	874	102	yes	317140	-
2891	scaffold_17	520411	521147	736	82	yes	217757	+
2892	scaffold_17	523741	523796	55	14	no	NA	NA
2893	scaffold_17	524008	524017	9	4	no	NA	NA
2894	scaffold_17	527250	528683	1433	144	yes	49755	+
2895	scaffold_17	536553	536825	272	30	yes	391346	+
2896	scaffold_17	543889	545177	1288	135	yes	412187	-
2897	scaffold_17	546914	547843	929	41	yes	424712	-
2898	scaffold_17	550881	552246	1365	91	yes	49797,49825	+,+
2899	scaffold_17	558277	559376	1099	135	yes	293743	-
2900	scaffold_17	560730	562063	1333	149	yes	412191	-
2901	scaffold_17	562327	563037	710	93	no	NA	NA
2902	scaffold_17	571860	572703	843	114	no	NA	NA
2903	scaffold_17	574028	575029	1001	54	yes	317165	+
2904	scaffold_17	578778	579629	851	117	yes	317172,391355	+,-
2905	scaffold_17	579890	580952	1062	130	yes	317172,391355	+,-
2906	scaffold_17	584558	585904	1346	179	yes	49929,317176	+,-
2907	scaffold_17	586181	587119	938	113	yes	49929,317176	+,-
2908	scaffold_17	596649	597757	1108	53	yes	243883	-
2909	scaffold_17	615566	615571	5	4	yes	391360	+
2910	scaffold_17	662455	663832	1377	112	yes	317201	+
2911	scaffold_17	667714	668350	636	49	yes	217691	-
2912	scaffold_17	675961	676851	890	82	yes	50049	-
2913	scaffold_17	682921	684805	1884	156	yes	293766	+
2914	scaffold_17	685156	686727	1571	206	yes	317213	+
2915	scaffold_17	693865	694024	159	8	no	NA	NA
2916	scaffold_17	701450	701629	179	17	no	NA	NA
2917	scaffold_17	706878	706931	53	15	yes	424735	-
2918	scaffold_17	713682	713773	91	16	no	NA	NA
2919	scaffold_17	722050	722064	14	4	no	NA	NA
2920	scaffold_17	728412	728494	82	16	no	NA	NA
2921	scaffold_17	729548	729574	26	6	no	NA	NA
2922	scaffold_17	738027	738981	954	64	yes	317224	+
2923	scaffold_17	746590	747137	547	34	yes	217621	+
2924	scaffold_17	759200	760313	1113	110	yes	317230	-
2925	scaffold_17	762755	763818	1063	113	no	NA	NA
2926	scaffold_17	766344	766992	648	46	yes	293779	+
2927	scaffold_17	770757	770801	44	8	yes	391379	+
2928	scaffold_17	773912	773959	47	14	yes	50166	+
2929	scaffold_17	774121	774471	350	30	yes	50166	+
2930	scaffold_17	785921	786608	687	54	yes	391381	-
2931	scaffold_17	792946	794207	1261	144	yes	317239	+
2932	scaffold_17	799891	800809	918	77	yes	317241	-
2933	scaffold_17	805112	805274	162	16	yes	424747	+
2934	scaffold_17	811334	812954	1620	153	yes	317243	-
2935	scaffold_17	814904	816271	1367	171	yes	243921	+
2936	scaffold_17	821544	822541	997	129	yes	370581	-
2937	scaffold_17	823568	824975	1407	113	yes	293793	+
2938	scaffold_17	829539	830649	1110	103	yes	317248	-
2939	scaffold_17	831362	831374	12	4	no	NA	NA
2940	scaffold_17	832086	832817	731	85	yes	50343,317250	+,-
2941	scaffold_17	833210	834423	1213	127	yes	50343,317250	+,-
2942	scaffold_17	835788	835796	8	3	no	NA	NA
2943	scaffold_17	836104	837213	1109	120	yes	317254	-
2944	scaffold_17	838981	839027	46	8	yes	412245	+
2945	scaffold_17	843578	844606	1028	98	yes	370583	+
2946	scaffold_17	848028	849077	1049	85	yes	317263	+
2947	scaffold_17	857704	859123	1419	120	yes	412250	+
2948	scaffold_17	869254	870463	1209	109	yes	412251	-
2949	scaffold_17	878137	878735	598	79	yes	424761	-
2950	scaffold_17	880673	882120	1447	118	yes	317278	+
2951	scaffold_17	884053	885520	1467	144	yes	317282	+
2952	scaffold_17	887571	888903	1332	120	yes	317284	+
2953	scaffold_17	889005	889036	31	8	no	NA	NA
2954	scaffold_17	892641	893745	1104	87	yes	412257	-
2955	scaffold_17	897813	898732	919	117	yes	317286	-
2956	scaffold_17	899363	901349	1986	226	yes	293814	+
2957	scaffold_17	905756	907157	1401	99	yes	317290	+
2958	scaffold_17	912807	913799	992	117	yes	317293	-
2959	scaffold_17	934120	935126	1006	114	yes	317297	+
2960	scaffold_17	935201	935420	219	20	no	NA	NA
2961	scaffold_17	938122	939392	1270	124	yes	317301	-
2962	scaffold_17	942408	943559	1151	126	yes	50730,317302	+,-
2963	scaffold_17	943844	944910	1066	122	yes	50730,317302	+,-
2964	scaffold_17	945882	946825	943	80	yes	317307	+
2965	scaffold_17	947077	948911	1834	188	yes	317309	-
2966	scaffold_17	949624	950939	1315	132	yes	317313	+
2967	scaffold_17	953234	954445	1211	152	yes	317316	+
2968	scaffold_17	958900	960115	1215	147	yes	317319	-
2969	scaffold_17	963680	965064	1384	150	yes	293828	-
2970	scaffold_17	968438	968611	173	6	yes	317328	+
2971	scaffold_17	968857	969703	846	61	yes	317328	+
2972	scaffold_17	972737	973907	1170	102	yes	317330	+
2973	scaffold_17	980686	980726	40	6	yes	317333	+
2974	scaffold_17	989135	990460	1325	178	yes	217784	-
2975	scaffold_17	1009129	1010735	1606	123	yes	317348	+
2976	scaffold_17	1014251	1015083	832	85	yes	317351	+
2977	scaffold_17	1025293	1027418	2125	200	yes	243964	-
2978	scaffold_17	1033079	1033196	117	16	no	NA	NA
2979	scaffold_17	1033277	1034427	1150	155	no	NA	NA
2980	scaffold_17	1040162	1041079	917	85	yes	217760	-
2981	scaffold_17	1041440	1043259	1819	168	yes	317364	-
2982	scaffold_17	1045901	1046605	704	99	yes	51029	-
2983	scaffold_17	1050994	1052288	1294	173	yes	391433	-
2984	scaffold_17	1053472	1054708	1236	168	yes	51055	+
2985	scaffold_17	1057883	1058488	605	102	yes	317368	+
2986	scaffold_17	1088777	1090222	1445	141	no	NA	NA
2987	scaffold_17	1091809	1092922	1113	70	yes	317391	+
2988	scaffold_17	1096479	1097839	1360	168	yes	317394	+
2989	scaffold_17	1100723	1102210	1487	147	yes	317395	+
2990	scaffold_17	1115144	1116602	1458	154	yes	317409	-
2991	scaffold_17	1118243	1119408	1165	135	yes	412303	+
2992	scaffold_17	1130017	1131347	1330	142	yes	217842	+
2993	scaffold_17	1131471	1132721	1250	70	no	NA	NA
2994	scaffold_17	1133079	1134791	1712	146	no	NA	NA
2995	scaffold_17	1143052	1143897	845	108	yes	412309	+
2996	scaffold_17	1147252	1148168	916	97	yes	317437	+
2997	scaffold_17	1151881	1153195	1314	124	yes	51310	-
2998	scaffold_17	1155232	1155981	749	108	yes	317438	-
2999	scaffold_17	1157891	1159038	1147	116	yes	317443	-
3000	scaffold_17	1160022	1160803	781	49	yes	51370	-
3001	scaffold_17	1167263	1168057	794	75	no	NA	NA
3002	scaffold_17	1184856	1186157	1301	131	yes	317451	-
3003	scaffold_17	1187047	1187658	611	47	no	NA	NA
3004	scaffold_21	531	1501	970	86	yes	409032	+
3005	scaffold_21	6983	7764	781	74	yes	319009	+
3006	scaffold_21	130538	130608	70	20	no	NA	NA
3007	scaffold_21	169604	170771	1167	139	no	NA	NA
3008	scaffold_21	180062	181315	1253	100	yes	319050	+
3009	scaffold_21	191626	193184	1558	138	yes	294574	+
3010	scaffold_21	202726	202942	216	26	no	NA	NA
3011	scaffold_21	203188	203966	778	61	yes	244603	-
3012	scaffold_21	220216	221508	1292	154	yes	294579	-
3013	scaffold_21	277068	277122	54	11	yes	371954	+
3014	scaffold_21	277255	277310	55	10	yes	371954	+
3015	scaffold_21	281893	282103	210	20	yes	72045	-
3016	scaffold_21	285731	286738	1007	104	yes	409111	-
3017	scaffold_21	294092	294724	632	58	yes	319080	+
3018	scaffold_21	315250	315785	535	79	yes	319093	-
3019	scaffold_21	329460	330512	1052	87	yes	409127	+
3020	scaffold_21	337403	338741	1338	138	yes	319097	-
3021	scaffold_21	340189	341369	1180	134	yes	319098	+
3022	scaffold_21	355872	357393	1521	179	yes	409133,425446	-,+
3023	scaffold_21	357705	359063	1358	159	yes	425446	+
3024	scaffold_21	401126	402795	1669	136	yes	319108	+
3025	scaffold_21	402927	402940	13	4	no	NA	NA
3026	scaffold_21	408224	408228	4	4	no	NA	NA
3027	scaffold_21	414365	415804	1439	124	yes	409146	+
3028	scaffold_21	425717	427545	1828	123	yes	294630	+
3029	scaffold_21	429149	430281	1132	134	no	NA	NA
3030	scaffold_21	464728	465371	643	50	yes	319128	+
3031	scaffold_21	473292	474065	773	76	yes	392083	-
3032	scaffold_21	484663	485375	712	64	yes	72316	-
3033	scaffold_21	494033	495854	1821	203	yes	319149	-
3034	scaffold_21	505533	506746	1213	178	yes	319158	+
3035	scaffold_21	538674	539888	1214	172	yes	319168	-
3036	scaffold_21	554679	555812	1133	136	yes	294654	+
3037	scaffold_21	564048	565111	1063	111	no	NA	NA
3038	scaffold_21	572144	573790	1646	169	yes	232143	-
3039	scaffold_21	577121	578064	943	115	yes	319193	-
3040	scaffold_21	580537	581548	1011	119	yes	319194	+
3041	scaffold_21	585269	586311	1042	116	yes	232151	+
3042	scaffold_21	591965	592924	959	131	yes	319199	-
3043	scaffold_21	595269	596268	999	101	yes	319200	-
3044	scaffold_21	614079	614277	198	9	yes	319206	+
3045	scaffold_21	618843	619452	609	84	yes	319208	-
3046	scaffold_21	621044	621190	146	26	no	NA	NA
3047	scaffold_21	621545	621549	4	4	no	NA	NA
3048	scaffold_21	621652	621843	191	41	no	NA	NA
3049	scaffold_21	622615	622695	80	24	no	NA	NA
3050	scaffold_21	660477	661317	840	97	yes	319236	-
3051	scaffold_21	682413	682430	17	8	no	NA	NA
3052	scaffold_21	686749	686934	185	16	yes	319270	-
3053	scaffold_21	689719	691202	1483	151	yes	409212	+
3054	scaffold_21	699378	700756	1378	136	yes	409215	-
3055	scaffold_21	723580	724642	1062	106	yes	385508	-
3056	scaffold_21	725438	726586	1148	202	yes	409218	+
3057	scaffold_21	730637	732000	1363	174	no	NA	NA
3058	scaffold_21	746782	748208	1426	161	yes	73032	-
3059	scaffold_21	750601	751397	796	81	yes	319292	-
3060	scaffold_21	751965	753059	1094	145	yes	319293	+
3061	scaffold_21	756293	757626	1333	138	yes	425520	-
3062	scaffold_21	763568	765099	1531	185	no	NA	NA
3063	scaffold_21	765800	766651	851	111	yes	425522	+
3064	scaffold_21	771981	771992	11	4	no	NA	NA
3065	scaffold_21	778490	779645	1155	119	yes	73163	-
3066	scaffold_21	781219	782235	1016	92	yes	319301	-
3067	scaffold_21	786578	787473	895	67	yes	319304	-
3068	scaffold_21	797941	799693	1752	202	yes	319310	+
3069	scaffold_21	800868	802063	1195	146	yes	392149	+
3070	scaffold_21	818704	819907	1203	59	yes	392154	-
3071	scaffold_21	820947	822022	1075	134	yes	196724	+
3072	scaffold_21	828642	830262	1620	168	no	NA	NA
3073	scaffold_21	853505	854641	1136	71	yes	409245	-
3074	scaffold_21	862098	862722	624	53	yes	244746	-
3075	scaffold_21	867089	867709	620	87	yes	319335	-
3076	scaffold_21	868979	869783	804	77	yes	425538	-
3077	scaffold_21	872355	872595	240	23	no	NA	NA
3078	scaffold_21	872687	873309	622	78	yes	319339	-
3079	scaffold_21	874297	875227	930	86	yes	392163	-
3080	scaffold_21	876212	876255	43	5	no	NA	NA
3081	scaffold_21	876519	877199	680	68	yes	244752	-
3082	scaffold_21	878496	879114	618	69	yes	425542	-
3083	scaffold_21	880562	881135	573	51	yes	392166	-
3084	scaffold_21	884006	885173	1167	129	yes	392167	-
3085	scaffold_21	886394	888036	1642	227	yes	425545	+
3086	scaffold_21	892181	893320	1139	130	no	NA	NA
3087	scaffold_21	896426	897860	1434	190	yes	244753,319358	-,+
3088	scaffold_21	898101	899048	947	103	yes	319358	+
3089	scaffold_21	901981	902790	809	80	yes	319360,319361	-,+
3090	scaffold_21	903163	904534	1371	180	yes	319360,319361	-,+
3091	scaffold_21	907122	907129	7	4	yes	244756	+
3092	scaffold_21	907600	907887	287	39	no	NA	NA
3093	scaffold_21	920505	920568	63	16	yes	319365	+
3094	scaffold_21	920786	920806	20	3	yes	319365	+
3095	scaffold_21	929749	931100	1351	139	yes	425554	-
3096	scaffold_21	932678	933484	806	83	no	NA	NA
3097	scaffold_21	937939	938914	975	110	yes	409267	-
3098	scaffold_21	942963	944842	1879	152	yes	73550	+
3099	scaffold_21	944992	945149	157	6	yes	73550	+
3100	scaffold_21	962951	963975	1024	142	yes	232246	-
3101	scaffold_21	967728	968930	1202	152	no	NA	NA
3102	scaffold_21	969100	970713	1613	191	yes	409277	+
3103	scaffold_21	974188	975497	1309	146	yes	294751	+
3104	scaffold_21	977600	978581	981	77	yes	319387	+
3105	scaffold_21	978664	978736	72	12	no	NA	NA
3106	scaffold_21	991163	991870	707	70	yes	392189	-
3107	scaffold_21	1002560	1003883	1323	115	yes	319399	-
3108	scaffold_21	1013517	1013527	10	6	yes	244767	-
3109	scaffold_21	1018217	1019965	1748	167	no	NA	NA
3110	scaffold_21	1027690	1027704	14	4	no	NA	NA
3111	scaffold_21	1030255	1030785	530	46	no	NA	NA
3112	scaffold_21	1030932	1031026	94	7	no	NA	NA
3113	scaffold_21	1059114	1059636	522	58	yes	218583	+
3114	scaffold_21	1064596	1065247	651	69	yes	294770	+
3115	scaffold_21	1072675	1073614	939	66	yes	232264	+
3116	scaffold_21	1085445	1086989	1544	191	yes	319424,409303	+,-
3117	scaffold_21	1087274	1088618	1344	215	yes	319424	+
3118	scaffold_21	1089212	1090142	930	70	yes	319428	+
3119	scaffold_21	1091779	1092194	415	31	yes	73884	+
3120	scaffold_21	1092512	1093342	830	94	no	NA	NA
3121	scaffold_21	1097353	1097367	14	4	yes	319433	+
3122	scaffold_21	1097522	1098670	1148	129	yes	319433	+
3123	scaffold_21	1098827	1098841	14	6	no	NA	NA
3124	scaffold_21	1100121	1100173	52	4	no	NA	NA
3125	scaffold_21	1100351	1101345	994	107	yes	372113	+
3126	scaffold_21	1101504	1102291	787	67	yes	372113	+
3127	scaffold_21	1104766	1105830	1064	119	yes	425584	-
3128	scaffold_27	3104	4426	1322	109	yes	321706	+
3129	scaffold_27	4546	4560	14	4	no	NA	NA
3130	scaffold_27	29481	31387	1906	167	yes	321720	-
3131	scaffold_27	33982	34854	872	64	yes	321723	+
3132	scaffold_27	55430	55584	154	10	no	NA	NA
3133	scaffold_27	58074	58233	159	18	no	NA	NA
3134	scaffold_27	60707	60871	164	18	no	NA	NA
3135	scaffold_27	63345	63496	151	12	no	NA	NA
3136	scaffold_27	66141	66151	10	6	no	NA	NA
3137	scaffold_27	69627	70621	994	106	yes	417667	-
3138	scaffold_27	72477	72634	157	14	yes	393130	+
3139	scaffold_27	77849	78866	1017	107	yes	87112	-
3140	scaffold_27	116828	117536	708	76	yes	321749	-
3141	scaffold_27	121740	121792	52	6	no	NA	NA
3142	scaffold_27	124432	125199	767	70	yes	393142	-
3143	scaffold_27	150794	151534	740	46	yes	321757	+
3144	scaffold_27	167096	167106	10	4	no	NA	NA
3145	scaffold_27	167504	168233	729	72	yes	87293	-
3146	scaffold_27	177333	177516	183	26	yes	321765	+
3147	scaffold_27	191993	192006	13	5	yes	393154	-
3148	scaffold_27	192165	192248	83	6	yes	393154	-
3149	scaffold_27	259175	259184	9	4	no	NA	NA
3150	scaffold_27	259525	260335	810	106	no	NA	NA
3151	scaffold_27	263574	264203	629	74	yes	393162	+
3152	scaffold_27	267181	267942	761	76	yes	87374	+
3153	scaffold_27	270108	270904	796	103	yes	321778	+
3154	scaffold_27	288657	289302	645	100	yes	321780	-
3155	scaffold_27	292513	294264	1751	241	yes	321781	+
3156	scaffold_27	302376	303742	1366	147	yes	321786	-
3157	scaffold_27	306446	307673	1227	138	yes	426536	-
3158	scaffold_27	308206	308960	754	67	yes	393171	+
3159	scaffold_27	309919	311421	1502	161	yes	321794	+
3160	scaffold_27	317368	318495	1127	145	yes	295888	-
3161	scaffold_27	320350	321662	1312	150	yes	426540	+
3162	scaffold_27	324687	325731	1044	123	yes	417731	+
3163	scaffold_27	328992	329616	624	90	yes	321804	+
3164	scaffold_27	346316	346863	547	39	yes	393180	+
3165	scaffold_27	347153	348023	870	104	no	NA	NA
3166	scaffold_27	374147	374699	552	53	yes	426551	-
3167	scaffold_27	375004	375159	155	16	yes	426551	-
3168	scaffold_27	431944	431987	43	13	no	NA	NA
3169	scaffold_27	453115	454095	980	134	yes	321818	-
3170	scaffold_27	457105	458271	1166	124	no	NA	NA
3171	scaffold_27	465227	466240	1013	124	yes	321825	-
3172	scaffold_27	467834	468855	1021	138	yes	365879	+
3173	scaffold_27	475414	476043	629	62	yes	321828	+
3174	scaffold_27	476223	476247	24	6	no	NA	NA
3175	scaffold_27	479882	481037	1155	137	yes	321830	+
3176	scaffold_27	486392	487163	771	57	yes	87701,393193	+,-
3177	scaffold_27	487407	487473	66	18	yes	87701,393193	+,-
3178	scaffold_27	487550	488247	697	117	yes	87701	+
3179	scaffold_27	504131	505638	1507	125	yes	87745	-
3180	scaffold_27	507022	508162	1140	164	yes	321849	+
3181	scaffold_27	508313	509586	1273	78	yes	321850	-
3182	scaffold_27	512294	513650	1356	153	yes	219778	+
3183	scaffold_27	541767	542819	1052	112	yes	426573	-
3184	scaffold_27	575520	575530	10	4	yes	295930	+
3185	scaffold_27	597230	597253	23	4	yes	426577	-
3186	scaffold_27	611799	612994	1195	139	no	NA	NA
3187	scaffold_27	616405	616615	210	21	yes	426581	-
3188	scaffold_27	622246	622415	169	22	yes	426582	-
3189	scaffold_27	641541	642246	705	62	no	NA	NA
3190	scaffold_27	651915	651961	46	12	no	NA	NA
3191	scaffold_27	652217	652248	31	6	no	NA	NA
3192	scaffold_27	664198	666034	1836	178	yes	417826	-
3193	scaffold_27	667637	668934	1297	148	yes	321895	+
3194	scaffold_27	687694	689057	1363	190	yes	393224	-
3195	scaffold_27	689301	689365	64	14	yes	393224	-
3196	scaffold_27	690471	691713	1242	122	yes	321903	+
3197	scaffold_27	697842	699375	1533	160	yes	219738	-
3198	scaffold_27	700801	700809	8	4	yes	321908	+
3199	scaffold_27	702875	703739	864	48	yes	88164	+
3200	scaffold_27	715610	716594	984	97	yes	393229	+
3201	scaffold_27	716861	716880	19	6	no	NA	NA
3202	scaffold_27	722227	722235	8	4	yes	321916	-
3203	scaffold_27	728578	729309	731	85	yes	321923	+
3204	scaffold_27	733068	733734	666	73	yes	321926	-
3205	scaffold_27	746260	746852	592	60	yes	321933	+
3206	scaffold_27	759689	760652	963	97	yes	321944	+
3207	scaffold_27	765761	766331	570	87	yes	417850	+
3208	scaffold_27	770402	771976	1574	168	yes	321949	+
3209	scaffold_27	798608	799315	707	75	yes	88308	-
3210	scaffold_27	808444	808947	503	49	yes	321966	+
3211	scaffold_27	829070	829350	280	22	yes	295982	+
3212	scaffold_27	846025	846778	753	92	no	NA	NA
3213	scaffold_27	852395	853386	991	132	yes	426620	-
3214	scaffold_27	868544	868603	59	10	no	NA	NA
3215	scaffold_27	868730	869430	700	82	yes	393253	-
3216	scaffold_27	873783	875098	1315	142	yes	321984	+
3217	scaffold_27	877908	878352	444	46	yes	321985	+
3218	scaffold_27	883963	884385	422	58	yes	321986	+
3219	scaffold_27	884622	884631	9	3	no	NA	NA
3220	scaffold_27	898427	898846	419	45	yes	88421	+
3221	scaffold_7	2364	2403	39	11	no	NA	NA
3222	scaffold_7	2500	3802	1302	119	yes	290975	+
3223	scaffold_7	41495	42540	1045	107	yes	422380	-
3224	scaffold_7	77139	77168	29	8	no	NA	NA
3225	scaffold_7	93828	94051	223	37	no	NA	NA
3226	scaffold_7	94357	95287	930	126	no	NA	NA
3227	scaffold_7	191334	191418	84	26	no	NA	NA
3228	scaffold_7	205601	205611	10	4	yes	400153	-
3229	scaffold_7	215838	216409	571	57	yes	389056	+
3230	scaffold_7	228351	228449	98	9	yes	310980	-
3231	scaffold_7	228767	228843	76	8	yes	310980	-
3232	scaffold_7	236423	237014	591	48	no	NA	NA
3233	scaffold_7	237188	237209	21	4	no	NA	NA
3234	scaffold_7	242269	242336	67	16	yes	380745	+
3235	scaffold_7	242784	242847	63	9	no	NA	NA
3236	scaffold_7	254799	255750	951	129	yes	422404	+
3237	scaffold_7	265400	267019	1619	168	no	NA	NA
3238	scaffold_7	300415	301175	760	77	no	NA	NA
3239	scaffold_7	312815	313585	770	52	yes	422407	-
3240	scaffold_7	315088	315949	861	79	yes	215241	+
3241	scaffold_7	338191	338275	84	28	no	NA	NA
3242	scaffold_7	456569	458124	1555	151	yes	311036	+
3243	scaffold_7	465621	465784	163	25	yes	400230	-
3244	scaffold_7	466008	467039	1031	119	yes	166064	-
3245	scaffold_7	471982	472341	359	18	no	NA	NA
3246	scaffold_7	494263	495377	1114	145	yes	166098	-
3247	scaffold_7	508186	509151	965	130	no	NA	NA
3248	scaffold_7	512685	513672	987	154	yes	311053	+
3249	scaffold_7	520145	521828	1683	142	yes	400238	-
3250	scaffold_7	582712	583190	478	45	no	NA	NA
3251	scaffold_7	583751	583779	28	4	no	NA	NA
3252	scaffold_7	584834	585821	987	118	yes	311154	-
3253	scaffold_7	587218	588240	1022	147	yes	422433	+
3254	scaffold_7	604252	605398	1146	126	yes	311160	+
3255	scaffold_7	623211	623825	614	72	yes	389089	-
3256	scaffold_7	649454	650422	968	109	yes	311181	+
3257	scaffold_7	650550	650653	103	13	no	NA	NA
3258	scaffold_7	665360	666289	929	107	no	NA	NA
3259	scaffold_7	690338	691670	1332	163	yes	291074,311202	-,+
3260	scaffold_7	692017	693173	1156	91	yes	311202	+
3261	scaffold_7	709202	709244	42	4	no	NA	NA
3262	scaffold_7	709437	709444	7	6	yes	291078	-
3263	scaffold_7	709560	710595	1035	75	yes	291078	-
3264	scaffold_7	718710	718726	16	4	no	NA	NA
3265	scaffold_7	719037	719857	820	112	yes	311216,422452	+,-
3266	scaffold_7	731475	731500	25	8	no	NA	NA
3267	scaffold_7	737746	739431	1685	165	yes	311219	-
3268	scaffold_7	739744	740615	871	78	yes	311219	-
3269	scaffold_7	740836	741947	1111	116	yes	311223	+
3270	scaffold_7	742222	743153	931	130	yes	311223	+
3271	scaffold_7	753903	755039	1136	146	yes	422459	+
3272	scaffold_7	767150	767818	668	80	yes	422462	+
3273	scaffold_7	768126	768172	46	8	no	NA	NA
3274	scaffold_7	773624	774808	1184	89	yes	311234	+
3275	scaffold_7	779003	779017	14	6	no	NA	NA
3276	scaffold_7	779115	780638	1523	182	yes	311237,311239	-,+
3277	scaffold_7	780911	781831	920	143	yes	311237,311239	-,+
3278	scaffold_7	788851	790056	1205	94	yes	291098	-
3279	scaffold_7	803016	803909	893	126	no	NA	NA
3280	scaffold_7	804349	804382	33	8	no	NA	NA
3281	scaffold_7	811469	812636	1167	100	yes	291100,311257	+,+
3282	scaffold_7	829230	830554	1324	196	yes	166757	-
3283	scaffold_7	831453	831542	89	12	no	NA	NA
3284	scaffold_7	831791	832696	905	112	yes	311272	-
3285	scaffold_7	835884	836894	1010	131	no	NA	NA
3286	scaffold_7	837203	837227	24	6	no	NA	NA
3287	scaffold_7	848050	848076	26	8	no	NA	NA
3288	scaffold_7	849010	849983	973	123	yes	311279	+
3289	scaffold_7	861545	862130	585	35	yes	166853	+
3290	scaffold_7	868656	869310	654	61	yes	311284	+
3291	scaffold_7	881495	882568	1073	119	yes	166893	+
3292	scaffold_7	893929	894945	1016	103	yes	311291	-
3293	scaffold_7	896189	896974	785	89	yes	311295,389136	+,-
3294	scaffold_7	897149	898211	1062	120	yes	311295,389136	+,-
3295	scaffold_7	899202	900123	921	92	yes	311298	+
3296	scaffold_7	900377	902000	1623	164	yes	311299	-
3297	scaffold_7	903082	904003	921	95	yes	311303	+
3298	scaffold_7	909815	910776	961	97	yes	422487	-
3299	scaffold_7	912285	913585	1300	130	yes	400334	+
3300	scaffold_7	925730	926047	317	52	no	NA	NA
3301	scaffold_7	930408	931970	1562	165	yes	311314	+
3302	scaffold_7	932057	932090	33	7	no	NA	NA
3303	scaffold_7	943296	944480	1184	89	yes	389148	-
3304	scaffold_7	944987	945343	356	20	no	NA	NA
3305	scaffold_7	948431	949747	1316	159	yes	311319	-
3306	scaffold_7	953729	954805	1076	111	yes	400341	-
3307	scaffold_7	961875	963287	1412	141	yes	400345	+
3308	scaffold_7	964777	964784	7	4	no	NA	NA
3309	scaffold_7	971005	971035	30	6	no	NA	NA
3310	scaffold_7	971347	971363	16	8	no	NA	NA
3311	scaffold_7	971918	973135	1217	106	no	NA	NA
3312	scaffold_7	974439	974498	59	18	no	NA	NA
3313	scaffold_7	975143	975200	57	15	no	NA	NA
3314	scaffold_7	976646	977907	1261	168	yes	311330	-
3315	scaffold_7	986650	987357	707	110	yes	311333	+
3316	scaffold_7	987819	987830	11	3	no	NA	NA
3317	scaffold_7	988533	989510	977	88	yes	389160	+
3318	scaffold_7	991877	992491	614	52	no	NA	NA
3319	scaffold_7	997770	998492	722	39	yes	311341	-
3320	scaffold_7	1002238	1002289	51	7	yes	311342	-
3321	scaffold_7	1002405	1002635	230	14	yes	311342	-
3322	scaffold_7	1003754	1005019	1265	126	yes	311343,311345	-,+
3323	scaffold_7	1005272	1005811	539	57	yes	311343,311345	-,+
3324	scaffold_7	1048912	1049633	721	77	no	NA	NA
3325	scaffold_7	1057960	1059459	1499	90	yes	400365	-
3326	scaffold_7	1069654	1069762	108	6	no	NA	NA
3327	scaffold_7	1069985	1070873	888	102	yes	311447	-
3328	scaffold_7	1074472	1074492	20	7	yes	400369	-
3329	scaffold_7	1084097	1084123	26	6	no	NA	NA
3330	scaffold_7	1089725	1090119	394	27	no	NA	NA
3331	scaffold_7	1119717	1121257	1540	148	yes	311454	-
3332	scaffold_7	1123557	1123669	112	24	no	NA	NA
3333	scaffold_7	1123984	1124583	599	63	no	NA	NA
3334	scaffold_7	1125873	1126692	819	74	yes	422526	-
3335	scaffold_7	1127120	1127683	563	56	yes	422526	-
3336	scaffold_7	1138398	1139212	814	69	yes	311460	-
3337	scaffold_7	1142598	1142605	7	4	no	NA	NA
3338	scaffold_7	1142949	1143402	453	48	yes	389181	-
3339	scaffold_7	1147815	1148041	226	25	no	NA	NA
3340	scaffold_7	1148516	1148922	406	62	yes	311463	-
3341	scaffold_7	1180932	1181894	962	79	yes	311468	-
3342	scaffold_7	1189471	1190450	979	135	yes	422537	+
3343	scaffold_7	1193474	1194403	929	86	yes	311472	+
3344	scaffold_7	1194526	1194595	69	22	yes	311472	+
3345	scaffold_7	1197614	1198944	1330	161	yes	215212	+
3346	scaffold_7	1229634	1230577	943	59	yes	400404	+
3347	scaffold_7	1244734	1246913	2179	150	yes	400406	+
3348	scaffold_7	1251160	1251735	575	66	yes	422543	-
3349	scaffold_7	1256030	1256328	298	40	no	NA	NA
3350	scaffold_7	1256458	1256695	237	24	no	NA	NA
3351	scaffold_7	1261222	1261242	20	6	yes	311498	+
3352	scaffold_7	1261589	1261622	33	4	no	NA	NA
3353	scaffold_7	1273238	1273469	231	27	yes	291191	+
3354	scaffold_7	1284436	1285869	1433	110	yes	311511	+
3355	scaffold_7	1290416	1291688	1272	174	yes	311512	+
3356	scaffold_7	1292326	1293681	1355	149	no	NA	NA
3357	scaffold_7	1294195	1294457	262	20	no	NA	NA
3358	scaffold_7	1294589	1294956	367	30	yes	311515	-
3359	scaffold_7	1299026	1299619	593	42	yes	400420	+
3360	scaffold_7	1304457	1305922	1465	156	no	NA	NA
3361	scaffold_7	1309168	1310399	1231	178	no	NA	NA
3362	scaffold_7	1317881	1318144	263	24	yes	311520	+
3363	scaffold_7	1333185	1334492	1307	100	yes	167736	-
3364	scaffold_7	1354548	1355802	1254	134	yes	422557	-
3365	scaffold_7	1356486	1357083	597	72	no	NA	NA
3366	scaffold_7	1357325	1357384	59	12	no	NA	NA
3367	scaffold_7	1380837	1380864	27	6	no	NA	NA
3368	scaffold_7	1386830	1387311	481	41	yes	389213	+
3369	scaffold_7	1403105	1404900	1795	226	yes	400439	-
3370	scaffold_7	1405055	1405678	623	87	yes	311540	+
3371	scaffold_7	1422923	1424632	1709	120	yes	311545	-
3372	scaffold_7	1427798	1428808	1010	122	yes	229184	+
3373	scaffold_7	1438654	1438941	287	30	yes	167889	-
3374	scaffold_7	1441528	1442478	950	102	yes	311549	-
3375	scaffold_7	1446631	1447368	737	68	no	NA	NA
3376	scaffold_7	1451046	1451668	622	68	yes	422576	-
3377	scaffold_7	1451842	1451995	153	8	yes	422576	-
3378	scaffold_7	1455714	1456650	936	132	yes	311553	+
3379	scaffold_7	1490764	1492256	1492	157	yes	389231	-
3380	scaffold_7	1494538	1497197	2659	240	yes	400459	-
3381	scaffold_7	1498774	1499555	781	68	yes	389233	-
3382	scaffold_7	1500882	1502176	1294	117	yes	311566	+
3383	scaffold_7	1506163	1506992	829	84	yes	400463	-
3384	scaffold_7	1511746	1512569	823	115	yes	311574	+
3385	scaffold_7	1516752	1517071	319	18	no	NA	NA
3386	scaffold_7	1517329	1518340	1011	82	yes	168060,311586	-,+
3387	scaffold_7	1518739	1520321	1582	206	yes	168060,311586	-,+
3388	scaffold_7	1534035	1535575	1540	123	yes	400470	-
3389	scaffold_7	1554194	1555028	834	51	yes	400474	+
3390	scaffold_7	1571061	1571698	637	77	no	NA	NA
3391	scaffold_8	4266	4470	204	10	yes	311608	+
3392	scaffold_8	18615	19541	926	88	yes	422597	-
3393	scaffold_8	97614	98597	983	126	yes	176040	-
3394	scaffold_8	98849	98867	18	4	yes	176040	-
3395	scaffold_8	104353	105348	995	123	no	NA	NA
3396	scaffold_8	105871	106749	878	112	yes	215432	+
3397	scaffold_8	108821	109904	1083	111	yes	311619	+
3398	scaffold_8	112570	114108	1538	132	yes	389259	-
3399	scaffold_8	116829	117549	720	69	yes	311621	+
3400	scaffold_8	123947	125194	1247	87	yes	389261	+
3401	scaffold_8	128956	129911	955	78	yes	291272	+
3402	scaffold_8	133841	135147	1306	166	yes	311628	-
3403	scaffold_8	142714	143862	1148	158	yes	389266	+
3404	scaffold_8	144173	144177	4	4	yes	389266	+
3405	scaffold_8	152427	153426	999	61	yes	291277	-
3406	scaffold_8	159312	160837	1525	123	yes	311634	+
3407	scaffold_8	163039	163429	390	34	yes	311637	-
3408	scaffold_8	164863	166217	1354	204	yes	311640	+
3409	scaffold_8	172546	173504	958	133	no	NA	NA
3410	scaffold_8	186023	187076	1053	108	yes	411399	+
3411	scaffold_8	198640	199908	1268	102	yes	411401	+
3412	scaffold_8	207236	208086	850	86	yes	311655	-
3413	scaffold_8	210551	211460	909	121	yes	291288	-
3414	scaffold_8	213387	213487	100	10	yes	311658	-
3415	scaffold_8	213615	213678	63	6	yes	311658	-
3416	scaffold_8	215164	217072	1908	219	yes	311663	+
3417	scaffold_8	223648	224904	1256	142	yes	229236	-
3418	scaffold_8	228091	229872	1781	211	yes	422628	+
3419	scaffold_8	240697	241160	463	60	yes	422630	+
3420	scaffold_8	249309	250345	1036	134	no	NA	NA
3421	scaffold_8	250437	250491	54	8	no	NA	NA
3422	scaffold_8	260002	260417	415	52	yes	311679	+
3423	scaffold_8	261153	263072	1919	206	yes	311682	-
3424	scaffold_8	271701	272536	835	97	yes	229241	-
3425	scaffold_8	279327	280445	1118	145	yes	311692	+
3426	scaffold_8	298329	298965	636	80	yes	241845	+
3427	scaffold_8	304502	306176	1674	187	yes	311699	+
3428	scaffold_8	309420	310805	1385	110	yes	311703,311704	-,+
3429	scaffold_8	316762	317671	909	121	yes	215466	-
3430	scaffold_8	320901	321936	1035	82	yes	389297	+
3431	scaffold_8	328306	329058	752	52	yes	422648	+
3432	scaffold_8	329335	329385	50	8	yes	422648	+
3433	scaffold_8	334739	336081	1342	120	yes	311709	+
3434	scaffold_8	345813	347370	1557	196	yes	176602	-
3435	scaffold_8	351441	352490	1049	111	yes	291312	-
3436	scaffold_8	358064	359047	983	118	yes	311720	-
3437	scaffold_8	359406	360610	1204	140	yes	311720,176663	-,+
3438	scaffold_8	362168	363463	1295	159	yes	422653	+
3439	scaffold_8	372529	372870	341	13	yes	311729	-
3440	scaffold_8	382138	382521	383	34	no	NA	NA
3441	scaffold_8	388563	389798	1235	97	yes	291320	+
3442	scaffold_8	394592	395946	1354	165	yes	291321	-
3443	scaffold_8	397546	399023	1477	156	yes	422657	+
3444	scaffold_8	413163	413170	7	4	no	NA	NA
3445	scaffold_8	437534	438593	1059	109	no	NA	NA
3446	scaffold_8	444504	445813	1309	124	yes	176873	+
3447	scaffold_8	446150	446158	8	4	no	NA	NA
3448	scaffold_8	452217	452269	52	14	no	NA	NA
3449	scaffold_8	455520	455619	99	25	no	NA	NA
3450	scaffold_8	457608	458915	1307	178	no	NA	NA
3451	scaffold_8	464208	464786	578	20	no	NA	NA
3452	scaffold_8	465170	466343	1173	99	yes	311752	+
3453	scaffold_8	467851	469151	1300	142	no	NA	NA
3454	scaffold_8	521052	521087	35	7	no	NA	NA
3455	scaffold_8	521175	522309	1134	188	yes	311765	-
3456	scaffold_8	522634	523654	1020	115	no	NA	NA
3457	scaffold_8	528646	529980	1334	93	yes	411464	+
3458	scaffold_8	532816	534505	1689	146	yes	422677	+
3459	scaffold_8	539569	540632	1063	110	yes	422678	-
3460	scaffold_8	540962	541910	948	124	yes	241897	+
3461	scaffold_8	544041	545038	997	141	yes	311775	+
3462	scaffold_8	545110	545159	49	11	no	NA	NA
3463	scaffold_8	570537	571921	1384	192	yes	365265	-
3464	scaffold_8	583005	583784	779	79	yes	291362	+
3465	scaffold_8	583888	583896	8	3	yes	291362	+
3466	scaffold_8	598612	598630	18	6	no	NA	NA
3467	scaffold_8	598777	599237	460	50	no	NA	NA
3468	scaffold_8	600543	601496	953	129	yes	177175	+
3469	scaffold_8	603078	604059	981	95	yes	422689	+
3470	scaffold_8	606235	607397	1162	99	yes	311796	+
3471	scaffold_8	615042	616440	1398	173	yes	389346	-
3472	scaffold_8	620024	620073	49	6	yes	291370	-
3473	scaffold_8	620572	620692	120	8	no	NA	NA
3474	scaffold_8	623654	624869	1215	184	yes	311806	+
3475	scaffold_8	632799	633711	912	99	no	NA	NA
3476	scaffold_8	636056	636752	696	73	yes	311817	-
3477	scaffold_8	637539	638302	763	114	yes	311818	+
3478	scaffold_8	639741	640726	985	111	yes	311823	+
3479	scaffold_8	642885	644223	1338	133	yes	311826	+
3480	scaffold_8	648518	650062	1544	149	yes	389356	+
3481	scaffold_8	659423	660617	1194	142	yes	422701	+
3482	scaffold_8	669050	670587	1537	175	yes	411494	-
3483	scaffold_8	683208	683399	191	10	no	NA	NA
3484	scaffold_8	683555	685065	1510	169	yes	422703	+
3485	scaffold_8	691379	692260	881	70	yes	311835	-
3486	scaffold_8	708332	709317	985	106	no	NA	NA
3487	scaffold_8	710792	711585	793	62	yes	311840	-
3488	scaffold_8	715966	717322	1356	135	yes	311844	-
3489	scaffold_8	721411	722261	850	82	yes	311848	+
3490	scaffold_8	727294	728933	1639	176	yes	177491	+
3491	scaffold_8	733917	733936	19	4	yes	291394	-
3492	scaffold_8	734266	735289	1023	82	yes	291394	-
3493	scaffold_8	741429	742610	1181	102	yes	215487	+
3494	scaffold_8	756061	757441	1380	98	yes	311862	-
3495	scaffold_8	764949	766102	1153	112	yes	311863	+
3496	scaffold_8	768496	770107	1611	157	yes	311864	+
3497	scaffold_8	771804	773118	1314	96	yes	422718	+
3498	scaffold_8	781750	782795	1045	53	yes	311871	-
3499	scaffold_8	783951	784956	1005	56	no	NA	NA
3500	scaffold_8	793972	795097	1125	122	yes	229339	-
3501	scaffold_8	798204	799310	1106	107	yes	411516	-
3502	scaffold_8	816602	817671	1069	131	yes	291407	+
3503	scaffold_8	824249	824434	185	14	yes	311887	+
3504	scaffold_8	824580	824640	60	11	yes	311887	+
3505	scaffold_8	827029	828348	1319	188	yes	389385	+
3506	scaffold_8	831509	833027	1518	179	yes	311889	+
3507	scaffold_8	835333	836259	926	112	yes	311892	-
3508	scaffold_8	842982	843020	38	10	no	NA	NA
3509	scaffold_8	843179	843777	598	58	yes	311896	-
3510	scaffold_8	857920	858636	716	98	yes	311902	+
3511	scaffold_8	860689	861485	796	60	yes	311903	+
3512	scaffold_8	862771	863918	1147	108	yes	291418	+
3513	scaffold_8	866201	867031	830	102	yes	385087	+
3514	scaffold_8	879525	880292	767	57	yes	311911	+
3515	scaffold_8	886276	887244	968	115	yes	311916	-
3516	scaffold_8	889065	890005	940	107	yes	177869	+
3517	scaffold_8	891893	893114	1221	170	no	NA	NA
3518	scaffold_8	906084	907537	1453	200	yes	311925,411541	+,-
3519	scaffold_8	908054	909327	1273	143	yes	311925	+
3520	scaffold_8	912484	912531	47	7	no	NA	NA
3521	scaffold_8	912690	914376	1686	141	yes	422744	-
3522	scaffold_8	921596	922772	1176	129	yes	291430	-
3523	scaffold_8	926321	927003	682	65	yes	311935	+
3524	scaffold_8	931796	932339	543	39	yes	389406	+
3525	scaffold_8	932941	933038	97	8	no	NA	NA
3526	scaffold_8	951026	952058	1032	117	yes	311952	-
3527	scaffold_8	957098	958216	1118	98	yes	411551	-
3528	scaffold_8	963422	964209	787	63	no	NA	NA
3529	scaffold_8	965104	966454	1350	156	yes	411553	+
3530	scaffold_8	970874	971938	1064	93	yes	411554	-
3531	scaffold_8	972287	974271	1984	219	yes	291438	+
3532	scaffold_8	994999	996121	1122	80	no	NA	NA
3533	scaffold_8	1025747	1026692	945	138	no	NA	NA
3534	scaffold_8	1028162	1029642	1480	158	yes	312059	+
3535	scaffold_8	1035984	1037458	1474	159	yes	312061	-
3536	scaffold_8	1052060	1052652	592	79	yes	179070	-
3537	scaffold_8	1052759	1052818	59	10	yes	179070	-
3538	scaffold_8	1057459	1058428	969	67	no	NA	NA
3539	scaffold_8	1064937	1065939	1002	140	yes	312083	-
3540	scaffold_8	1067735	1068532	797	59	yes	312086	-
3541	scaffold_8	1070279	1071089	810	92	no	NA	NA
3542	scaffold_8	1071312	1071334	22	3	no	NA	NA
3543	scaffold_8	1073230	1074510	1280	141	yes	241985,312092,422770	+,-,-
3544	scaffold_8	1074894	1075279	385	37	yes	241985,422770	+,-
3545	scaffold_8	1077364	1078311	947	126	yes	312094	+
3546	scaffold_8	1079515	1079686	171	24	no	NA	NA
3547	scaffold_8	1085236	1086371	1135	128	yes	179187	-
3548	scaffold_8	1092490	1092991	501	43	yes	312098	-
3549	scaffold_8	1101070	1101989	919	78	no	NA	NA
3550	scaffold_8	1110508	1111985	1477	171	yes	312105	+
3551	scaffold_8	1122675	1123392	717	59	yes	179389	+
3552	scaffold_8	1130170	1131079	909	94	yes	312120	-
3553	scaffold_8	1132821	1133361	540	57	no	NA	NA
3554	scaffold_8	1138142	1139314	1172	121	yes	179498	-
3555	scaffold_8	1141634	1142838	1204	127	yes	215689	+
3556	scaffold_8	1149421	1150638	1217	170	yes	312134,411584	+,-
3557	scaffold_8	1153845	1154960	1115	116	yes	411586	+
3558	scaffold_8	1165296	1166486	1190	117	yes	312141	-
3559	scaffold_8	1167241	1168729	1488	180	yes	312144	+
3560	scaffold_8	1173218	1173243	25	6	no	NA	NA
3561	scaffold_8	1173346	1174000	654	78	yes	312147	-
3562	scaffold_8	1188039	1189444	1405	109	yes	312148	+
3563	scaffold_8	1196626	1197550	924	123	yes	179601	-
3564	scaffold_8	1211706	1212662	956	106	no	NA	NA
3565	scaffold_8	1213292	1215051	1759	173	no	NA	NA
3566	scaffold_8	1218243	1219523	1280	165	yes	312152	+
3567	scaffold_8	1233247	1234315	1068	131	yes	215650	+
3568	scaffold_8	1238232	1239190	958	89	yes	312158	-
3569	scaffold_8	1239941	1241042	1101	118	yes	242016	+
3570	scaffold_8	1245929	1247109	1180	129	yes	312165	-
3571	scaffold_8	1248243	1249900	1657	98	yes	312167	+
3572	scaffold_8	1262825	1263886	1061	114	yes	179769	-
3573	scaffold_8	1264296	1264393	97	14	yes	179769,312172	-,+
3574	scaffold_8	1264643	1265209	566	39	yes	312172	+
3575	scaffold_8	1268002	1268899	897	114	yes	312174	+
3576	scaffold_8	1285733	1286913	1180	132	yes	389459	-
3577	scaffold_8	1287194	1288817	1623	160	yes	389459,312178	-,+
3578	scaffold_8	1289131	1289922	791	64	yes	312178	+
3579	scaffold_8	1292293	1293786	1493	148	yes	411617	+
3580	scaffold_8	1297974	1299039	1065	103	yes	422806	-
3581	scaffold_8	1299722	1299990	268	29	yes	422806	-
3582	scaffold_8	1300156	1300293	137	14	no	NA	NA
3583	scaffold_8	1304498	1304628	130	22	yes	312184	-
3584	scaffold_8	1326316	1327468	1152	151	yes	291502	-
3585	scaffold_8	1331053	1332048	995	98	yes	242027	-
3586	scaffold_8	1332893	1333899	1006	103	no	NA	NA
3587	scaffold_8	1336598	1337283	685	77	yes	312202	+
3588	scaffold_8	1340913	1342178	1265	184	yes	365291	-
3589	scaffold_8	1344599	1345493	894	74	yes	312207	+
3590	scaffold_8	1348242	1348645	403	35	yes	312210	-
3591	scaffold_8	1351278	1351866	588	74	yes	312212	-
3592	scaffold_8	1353624	1354538	914	86	yes	312216	-
3593	scaffold_8	1359283	1360400	1117	148	yes	291512	-
3594	scaffold_8	1364060	1365151	1091	84	no	NA	NA
3595	scaffold_8	1371750	1373906	2156	218	no	NA	NA
3596	scaffold_8	1382973	1383941	968	66	yes	312221	+
3597	scaffold_8	1404898	1406055	1157	166	no	NA	NA
3598	scaffold_8	1408741	1409636	895	96	yes	411641	+
3599	scaffold_8	1419318	1420081	763	93	yes	312232	+
3600	scaffold_8	1421540	1422619	1079	173	yes	312234,312235	+,+
3601	scaffold_8	1423645	1424130	485	48	no	NA	NA
3602	scaffold_8	1425409	1427054	1645	209	yes	312238	+
3603	scaffold_8	1433591	1433739	148	12	no	NA	NA
3604	scaffold_8	1434066	1434082	16	8	no	NA	NA
3605	scaffold_8	1500641	1500679	38	12	yes	389491	-
3606	scaffold_8	1503177	1503186	9	4	no	NA	NA
3607	scaffold_29	12695	14134	1439	142	yes	426732	-
3608	scaffold_29	15615	16626	1011	122	yes	409357	+
3609	scaffold_29	23270	24679	1409	145	yes	245789	-
3610	scaffold_29	41878	42878	1000	143	yes	426735	-
3611	scaffold_29	45678	46904	1226	125	yes	322249	-
3612	scaffold_29	47272	47670	398	45	yes	322249	-
3613	scaffold_29	48233	48309	76	14	yes	393361	-
3614	scaffold_29	49638	50175	537	55	no	NA	NA
3615	scaffold_29	62064	63279	1215	123	yes	322253	-
3616	scaffold_29	76825	77736	911	115	yes	245790	-
3617	scaffold_29	79425	80347	922	120	yes	426746	+
3618	scaffold_29	80590	81855	1265	159	yes	426746	+
3619	scaffold_29	81967	81986	19	4	no	NA	NA
3620	scaffold_29	84826	85875	1049	115	yes	322263	+
3621	scaffold_29	87964	89073	1109	100	yes	245799	+
3622	scaffold_29	91827	92953	1126	117	yes	409373	+
3623	scaffold_29	93138	93147	9	3	yes	409373	+
3624	scaffold_29	102723	104003	1280	166	yes	409375	-
3625	scaffold_29	112514	113631	1117	139	yes	322281	+
3626	scaffold_29	113959	114019	60	12	no	NA	NA
3627	scaffold_29	117586	117610	24	8	no	NA	NA
3628	scaffold_29	117793	118765	972	106	yes	322283	-
3629	scaffold_29	121695	122580	885	92	yes	322286	+
3630	scaffold_29	126268	127268	1000	51	yes	90425	-
3631	scaffold_29	133614	134984	1370	172	yes	322295	+
3632	scaffold_29	141119	142433	1314	140	yes	409384	-
3633	scaffold_29	145120	146043	923	70	yes	322297,322299	-,+
3634	scaffold_29	162311	164461	2150	167	yes	296173	+
3635	scaffold_29	166169	166409	240	20	yes	322306	+
3636	scaffold_29	170189	171371	1182	130	yes	296175	-
3637	scaffold_29	175822	177486	1664	101	yes	322308	+
3638	scaffold_29	177588	177681	93	4	yes	322308	+
3639	scaffold_29	195105	195880	775	76	yes	393391	-
3640	scaffold_29	202955	202970	15	6	no	NA	NA
3641	scaffold_29	261892	262102	210	16	yes	322341	+
3642	scaffold_29	262228	262244	16	6	yes	322341	+
3643	scaffold_29	291264	292042	778	80	no	NA	NA
3644	scaffold_29	293239	293701	462	36	no	NA	NA
3645	scaffold_29	295963	296727	764	76	yes	426783,426784	-,+
3646	scaffold_29	301938	303290	1352	158	yes	393408	+
3647	scaffold_29	312204	312796	592	86	yes	322359	+
3648	scaffold_29	316387	317380	993	110	yes	322362	+
3649	scaffold_29	318724	321233	2509	309	yes	322365,322366	+,+
3650	scaffold_29	321462	322756	1294	175	yes	322366	+
3651	scaffold_29	334111	335156	1045	72	yes	322373	+
3652	scaffold_29	335223	335295	72	6	no	NA	NA
3653	scaffold_29	336859	337254	395	22	yes	233408	+
3654	scaffold_29	341975	343255	1280	159	yes	90959	-
3655	scaffold_29	344727	345519	792	63	yes	90980	-
3656	scaffold_29	356705	357186	481	66	yes	393418	+
3657	scaffold_29	363477	364755	1278	102	yes	219918	+
3658	scaffold_29	380482	381725	1243	171	yes	322411	-
3659	scaffold_29	385388	386202	814	71	yes	393422	+
3660	scaffold_29	389984	390612	628	79	yes	426799	+
3661	scaffold_29	395855	397375	1520	187	yes	322418,393425	-,+
3662	scaffold_29	397567	398881	1314	140	yes	393425	+
3663	scaffold_29	412045	413140	1095	133	yes	393427	-
3664	scaffold_29	414692	415914	1222	135	yes	322429	+
3665	scaffold_29	443538	443553	15	4	no	NA	NA
3666	scaffold_29	443977	444844	867	101	yes	426807	-
3667	scaffold_29	448317	448390	73	15	no	NA	NA
3668	scaffold_29	448632	448688	56	14	no	NA	NA
3669	scaffold_29	448818	448844	26	8	no	NA	NA
3670	scaffold_29	449166	449201	35	4	no	NA	NA
3671	scaffold_29	449351	449365	14	6	no	NA	NA
3672	scaffold_29	456386	456861	475	29	yes	426809	+
3673	scaffold_29	457126	457726	600	56	yes	426809	+
3674	scaffold_29	461537	461978	441	45	yes	322442	+
3675	scaffold_29	473655	474734	1079	76	yes	91332	-
3676	scaffold_29	476278	476938	660	53	yes	393439	+
3677	scaffold_29	495050	495956	906	82	yes	426817	-
3678	scaffold_29	502374	503522	1148	172	yes	409457,409458	-,-
3679	scaffold_29	511907	513368	1461	122	yes	426820	-
3680	scaffold_29	531301	532449	1148	168	yes	393448,393450	-,+
3681	scaffold_29	544114	545405	1291	166	yes	426826	-
3682	scaffold_29	550049	551216	1167	160	no	NA	NA
3683	scaffold_29	560072	561220	1148	170	yes	91523,322476	-,+
3684	scaffold_29	561791	562695	904	93	yes	322476	+
3685	scaffold_29	570709	571693	984	106	yes	322480	-
3686	scaffold_29	577372	578359	987	122	yes	322486	-
3687	scaffold_29	579357	580471	1114	150	yes	91592	+
3688	scaffold_29	584736	586180	1444	150	yes	322490,393462	-,+
3689	scaffold_29	586565	586839	274	29	yes	322490,393462	-,+
3690	scaffold_29	586940	587023	83	16	yes	393462	+
3691	scaffold_29	587107	587370	263	22	no	NA	NA
3692	scaffold_29	595875	597436	1561	180	no	NA	NA
3693	scaffold_29	598570	599683	1113	126	yes	91639	+
3694	scaffold_29	613248	614700	1452	195	yes	385675	-
3695	scaffold_29	619283	620238	955	90	yes	233450	+
3696	scaffold_29	645843	646395	552	55	no	NA	NA
3697	scaffold_29	652012	653076	1064	118	yes	322506	+
3698	scaffold_29	657940	659327	1387	179	yes	322508	+
3699	scaffold_29	663876	664340	464	58	yes	393472	+
3700	scaffold_29	664814	664852	38	4	no	NA	NA
3701	scaffold_29	673584	674918	1334	117	yes	409488	+
3702	scaffold_29	685147	686506	1359	154	yes	322516	-
3703	scaffold_29	689152	690778	1626	197	yes	322518	-
3704	scaffold_29	711078	711958	880	49	yes	322526	+
3705	scaffold_29	714100	715791	1691	169	yes	220024	+
3706	scaffold_29	726913	727898	985	113	yes	92023,426855,426857	-,-,+
3707	scaffold_29	728143	729375	1232	159	yes	92023,426857	-,+
3708	scaffold_29	739618	741078	1460	172	yes	296286	-
3709	scaffold_29	742211	743097	886	118	yes	92057	+
3710	scaffold_29	743290	743336	46	4	no	NA	NA
3711	scaffold_29	746284	747576	1292	146	yes	426860	-
3712	scaffold_29	749746	750782	1036	94	yes	92095	-
3713	scaffold_29	752568	753151	583	48	yes	219954	+
3714	scaffold_29	755946	756791	845	75	yes	322547	+
3715	scaffold_29	760967	761860	893	80	yes	322549	+
3716	scaffold_29	762030	762037	7	4	no	NA	NA
3717	scaffold_29	770615	771392	777	68	yes	233475	-
3718	scaffold_29	772415	773236	821	99	yes	393496	+
3719	scaffold_29	782810	783783	973	116	yes	409509	+
3720	scaffold_29	788311	789480	1169	144	yes	322564	+
3721	scaffold_29	792077	794121	2044	216	yes	322568	+
3722	scaffold_29	794400	795510	1110	144	yes	322568	+
3723	scaffold_29	801488	802657	1169	111	yes	322573	+
3724	scaffold_29	809922	811076	1154	129	yes	322576	+
3725	scaffold_29	816829	816857	28	8	yes	393503	-
3726	scaffold_29	818135	819042	907	100	yes	322581	-
3727	scaffold_29	820724	821790	1066	113	yes	92285	-
3728	scaffold_29	823784	825440	1656	186	yes	426875	-
3729	scaffold_29	828584	829461	877	64	yes	322590	-
3730	scaffold_29	832670	833474	804	92	yes	426877	+
3731	scaffold_29	846538	847684	1146	113	yes	393510	-
3732	scaffold_29	848710	849708	998	115	yes	393511	+
3733	scaffold_29	860120	860919	799	89	yes	426883	+
3734	scaffold_29	877530	878700	1170	144	yes	393516	+
3735	scaffold_16	21090	22180	1090	153	no	NA	NA
3736	scaffold_16	24552	25138	586	57	yes	316495	-
3737	scaffold_16	31424	32834	1410	154	yes	365572	-
3738	scaffold_16	34783	36417	1634	156	yes	217576	+
3739	scaffold_16	36552	36561	9	4	no	NA	NA
3740	scaffold_16	39143	39708	565	54	yes	316504	-
3741	scaffold_16	41012	42571	1559	198	yes	391084	+
3742	scaffold_16	48877	49192	315	28	yes	45501	+
3743	scaffold_16	84717	85707	990	69	yes	391091	-
3744	scaffold_16	99959	101588	1629	198	no	NA	NA
3745	scaffold_16	101736	101745	9	4	no	NA	NA
3746	scaffold_16	105230	106634	1404	149	no	NA	NA
3747	scaffold_16	121471	122634	1163	96	yes	316524	+
3748	scaffold_16	127285	128452	1167	129	yes	316531	-
3749	scaffold_16	128796	129590	794	117	yes	316531	-
3750	scaffold_16	137762	139055	1293	113	yes	418496	-
3751	scaffold_16	145523	146042	519	43	yes	316538	+
3752	scaffold_16	148855	150070	1215	105	yes	316539	+
3753	scaffold_16	152070	153353	1283	145	yes	45684	-
3754	scaffold_16	153641	153652	11	5	yes	45684	-
3755	scaffold_16	168830	169850	1020	95	no	NA	NA
3756	scaffold_16	170087	171315	1228	145	yes	424465	+
3757	scaffold_16	174503	175329	826	59	yes	418504	+
3758	scaffold_16	179785	180159	374	47	no	NA	NA
3759	scaffold_16	200505	201796	1291	114	yes	316558	-
3760	scaffold_16	203213	204162	949	121	yes	316561	+
3761	scaffold_16	206345	207715	1370	172	yes	316563	+
3762	scaffold_16	211588	212662	1074	99	yes	45854	-
3763	scaffold_16	224305	224903	598	36	yes	391116	-
3764	scaffold_16	230125	231842	1717	206	yes	293460	-
3765	scaffold_16	236980	237883	903	47	yes	293461	-
3766	scaffold_16	243061	244045	984	73	yes	316571	-
3767	scaffold_16	249836	251207	1371	125	yes	293463	-
3768	scaffold_16	251755	252758	1003	94	yes	316577	-
3769	scaffold_16	282332	282350	18	6	yes	424484	-
3770	scaffold_16	294990	295272	282	29	no	NA	NA
3771	scaffold_16	303059	304355	1296	107	no	NA	NA
3772	scaffold_16	307611	307625	14	6	no	NA	NA
3773	scaffold_16	309465	310720	1255	160	yes	316592,424489	-,+
3774	scaffold_16	318266	319183	917	115	yes	424491	-
3775	scaffold_16	322669	323986	1317	156	yes	418538	-
3776	scaffold_16	324753	326356	1603	203	yes	316599	+
3777	scaffold_16	329564	330831	1267	104	yes	316601	+
3778	scaffold_16	334870	336280	1410	156	yes	293478	-
3779	scaffold_16	341398	342317	919	85	yes	316607	+
3780	scaffold_16	347812	348849	1037	124	yes	316613	-
3781	scaffold_16	351070	351485	415	49	no	NA	NA
3782	scaffold_16	355782	357091	1309	148	yes	316614	-
3783	scaffold_16	360601	361191	590	39	yes	418548	-
3784	scaffold_16	372316	372679	363	30	yes	316623	+
3785	scaffold_16	372919	373012	93	4	no	NA	NA
3786	scaffold_16	394722	395458	736	82	no	NA	NA
3787	scaffold_16	397066	397333	267	25	yes	316657	+
3788	scaffold_16	407220	407907	687	64	yes	293488	-
3789	scaffold_16	415451	416484	1033	57	yes	316666	+
3790	scaffold_16	423501	424077	576	60	yes	46334	-
3791	scaffold_16	426011	427450	1439	121	yes	46340	+
3792	scaffold_16	431696	431745	49	6	no	NA	NA
3793	scaffold_16	432088	433383	1295	143	yes	316670	-
3794	scaffold_16	434446	436032	1586	186	yes	316674	+
3795	scaffold_16	444950	446655	1705	152	no	NA	NA
3796	scaffold_16	450534	450546	12	6	no	NA	NA
3797	scaffold_16	456896	456934	38	11	no	NA	NA
3798	scaffold_16	475247	476436	1189	103	yes	391152	+
3799	scaffold_16	493826	495827	2001	183	yes	316693	-
3800	scaffold_16	505967	506792	825	73	yes	293504	+
3801	scaffold_16	506912	506921	9	4	no	NA	NA
3802	scaffold_16	508547	509635	1088	127	yes	293505	+
3803	scaffold_16	511800	512746	946	109	yes	316699	-
3804	scaffold_16	515156	516571	1415	179	yes	316701	+
3805	scaffold_16	520946	521906	960	109	yes	316703	+
3806	scaffold_16	537760	537775	15	6	no	NA	NA
3807	scaffold_16	537869	538966	1097	96	no	NA	NA
3808	scaffold_16	544932	545951	1019	99	yes	316704	+
3809	scaffold_16	652901	653759	858	124	no	NA	NA
3810	scaffold_16	656325	657107	782	73	yes	424528	+
3811	scaffold_16	658676	659900	1224	112	yes	316719,418635	+,-
3812	scaffold_16	660158	661209	1051	123	yes	316719	+
3813	scaffold_16	668687	670028	1341	134	yes	316726	+
3814	scaffold_16	679015	679026	11	5	no	NA	NA
3815	scaffold_16	679207	679958	751	87	no	NA	NA
3816	scaffold_16	681491	682291	800	112	yes	316728	-
3817	scaffold_16	685180	686768	1588	146	no	NA	NA
3818	scaffold_16	686911	686918	7	4	no	NA	NA
3819	scaffold_16	697764	698373	609	74	no	NA	NA
3820	scaffold_16	700330	700861	531	52	yes	316733	-
3821	scaffold_16	701734	702423	689	82	no	NA	NA
3822	scaffold_16	709949	711092	1143	138	yes	424541	-
3823	scaffold_16	729697	731041	1344	118	no	NA	NA
3824	scaffold_16	736036	736044	8	4	no	NA	NA
3825	scaffold_16	736669	737488	819	81	no	NA	NA
3826	scaffold_16	757165	758595	1430	169	yes	316743	-
3827	scaffold_16	772738	773622	884	98	yes	293541	+
3828	scaffold_16	786161	787255	1094	149	yes	316752	-
3829	scaffold_16	792882	793950	1068	96	yes	316755	+
3830	scaffold_16	798521	799667	1146	115	yes	46929	-
3831	scaffold_16	800907	802368	1461	123	yes	231216	+
3832	scaffold_16	804862	804876	14	4	yes	424554	+
3833	scaffold_16	805090	806516	1426	142	yes	424554	+
3834	scaffold_16	809591	810601	1010	52	yes	418665	-
3835	scaffold_16	820809	822152	1343	120	yes	217591	+
3836	scaffold_16	829382	830050	668	76	yes	316764	+
3837	scaffold_16	842380	843495	1115	92	yes	316768	-
3838	scaffold_16	844802	845728	926	87	yes	316769	+
3839	scaffold_16	848199	849249	1050	154	yes	243756,370248	-,+
3840	scaffold_16	851654	852583	929	112	yes	316776	+
3841	scaffold_16	855135	856515	1380	180	yes	217520	+
3842	scaffold_16	874367	875070	703	79	yes	316781	-
3843	scaffold_16	889302	889311	9	4	no	NA	NA
3844	scaffold_16	936393	936896	503	58	no	NA	NA
3845	scaffold_16	938380	939508	1128	145	yes	47271	+
3846	scaffold_16	954519	955467	948	114	yes	424576	-
3847	scaffold_16	962958	964544	1586	131	yes	391205	+
3848	scaffold_16	964908	966223	1315	187	yes	316818	+
3849	scaffold_16	973074	974014	940	135	yes	293581,316821	+,-
3850	scaffold_16	974434	975408	974	77	yes	293581,316821	+,-
3851	scaffold_16	989410	990767	1357	108	yes	243763	+
3852	scaffold_16	1007651	1007657	6	3	no	NA	NA
3853	scaffold_16	1013586	1015246	1660	174	yes	316835	-
3854	scaffold_16	1016821	1018424	1603	172	yes	217535	+
3855	scaffold_16	1040510	1040518	8	4	yes	391213	-
3856	scaffold_16	1041097	1041109	12	6	yes	391213	-
3857	scaffold_16	1054344	1055458	1114	154	yes	47438	-
3858	scaffold_16	1055702	1056183	481	73	yes	47438	-
3859	scaffold_16	1063253	1066406	3153	290	yes	47466,316844,316846	+,+,-
3860	scaffold_16	1066881	1067760	879	97	yes	47466,316846	+,-
3861	scaffold_16	1073795	1073809	14	6	no	NA	NA
3862	scaffold_16	1074413	1075925	1512	160	yes	391220	+
3863	scaffold_16	1085520	1086682	1162	147	yes	243770	-
3864	scaffold_16	1099031	1100172	1141	137	yes	418726	+
3865	scaffold_16	1116752	1117911	1159	86	yes	293600	+
3866	scaffold_16	1126836	1127012	176	15	yes	47543	-
3867	scaffold_16	1133539	1133852	313	33	no	NA	NA
3868	scaffold_16	1143388	1143456	68	20	no	NA	NA
3869	scaffold_16	1150628	1150681	53	12	no	NA	NA
3870	scaffold_16	1152584	1152613	29	10	no	NA	NA
3871	scaffold_16	1153523	1153583	60	16	no	NA	NA
3872	scaffold_16	1155384	1155461	77	16	no	NA	NA
3873	scaffold_16	1156157	1156417	260	22	yes	418738	+
3874	scaffold_16	1175807	1177083	1276	141	yes	418744	-
3875	scaffold_16	1185759	1185819	60	15	no	NA	NA
3876	scaffold_16	1186916	1186934	18	6	no	NA	NA
3877	scaffold_16	1203876	1203943	67	16	no	NA	NA
3878	scaffold_16	1205124	1205191	67	17	no	NA	NA
3879	scaffold_16	1212809	1212877	68	15	no	NA	NA
3880	scaffold_16	1213837	1213905	68	15	no	NA	NA
3881	scaffold_3	23401	24556	1155	147	yes	387709	-
3882	scaffold_3	31288	31388	100	15	no	NA	NA
3883	scaffold_3	31507	31735	228	40	no	NA	NA
3884	scaffold_3	32245	33202	957	126	yes	373896	+
3885	scaffold_3	38783	40169	1386	166	yes	307775	-
3886	scaffold_3	41583	42866	1283	151	yes	307778	+
3887	scaffold_3	48177	49885	1708	103	yes	214292,307783	-,+
3888	scaffold_3	53264	53275	11	4	no	NA	NA
3889	scaffold_3	63479	64639	1160	162	yes	307788	+
3890	scaffold_3	85283	85303	20	4	no	NA	NA
3891	scaffold_3	85407	86185	778	100	no	NA	NA
3892	scaffold_3	106351	107388	1037	150	no	NA	NA
3893	scaffold_3	111919	112302	383	37	yes	404841	-
3894	scaffold_3	112480	112739	259	19	no	NA	NA
3895	scaffold_3	134933	134942	9	4	no	NA	NA
3896	scaffold_3	135084	135172	88	9	no	NA	NA
3897	scaffold_3	135245	135385	140	13	no	NA	NA
3898	scaffold_3	155961	156763	802	74	yes	92921	+
3899	scaffold_3	163056	163612	556	47	yes	384846	-
3900	scaffold_3	170460	171894	1434	130	yes	404850	-
3901	scaffold_3	175346	176458	1112	141	yes	373933,387729	-,-
3902	scaffold_3	176544	176591	47	9	yes	373933	-
3903	scaffold_3	184398	186252	1854	124	yes	289412	+
3904	scaffold_3	190383	191410	1027	89	yes	307820	-
3905	scaffold_3	192128	192160	32	8	no	NA	NA
3906	scaffold_3	192235	192465	230	30	no	NA	NA
3907	scaffold_3	195053	196610	1557	124	yes	421088	-
3908	scaffold_3	198771	199739	968	113	no	NA	NA
3909	scaffold_3	206505	207939	1434	131	yes	421089	-
3910	scaffold_3	218635	219507	872	101	no	NA	NA
3911	scaffold_3	224182	225385	1203	135	yes	307834,421092	-,-
3912	scaffold_3	227986	228778	792	79	yes	307835,404864	-,-
3913	scaffold_3	244898	246313	1415	101	yes	307850	-
3914	scaffold_3	250662	251423	761	91	no	NA	NA
3915	scaffold_3	261475	261498	23	6	no	NA	NA
3916	scaffold_3	261784	263054	1270	124	yes	307853	-
3917	scaffold_3	265744	266726	982	114	yes	421101	-
3918	scaffold_3	273681	275206	1525	135	no	NA	NA
3919	scaffold_3	282856	283629	773	84	no	NA	NA
3920	scaffold_3	291188	291468	280	25	yes	307861	-
3921	scaffold_3	297137	298407	1270	134	yes	307862	+
3922	scaffold_3	303041	304723	1682	188	yes	421107	-
3923	scaffold_3	306292	307693	1401	137	yes	421108	+
3924	scaffold_3	311039	311155	116	12	yes	307868	+
3925	scaffold_3	311388	311902	514	71	yes	307868,307871	+,+
3926	scaffold_3	313411	314711	1300	129	no	NA	NA
3927	scaffold_3	319841	320279	438	19	yes	214108	-
3928	scaffold_3	335428	336591	1163	122	yes	213967	+
3929	scaffold_3	341363	342155	792	80	no	NA	NA
3930	scaffold_3	344973	346081	1108	116	yes	240480	-
3931	scaffold_3	346577	347789	1212	128	yes	240480,307886	-,+
3932	scaffold_3	352497	353306	809	105	yes	93320	-
3933	scaffold_3	354771	355820	1049	123	yes	387758	+
3934	scaffold_3	355936	355971	35	6	no	NA	NA
3935	scaffold_3	370694	371399	705	61	yes	307893	+
3936	scaffold_3	375277	376598	1321	148	yes	93338	-
3937	scaffold_3	396483	397376	893	73	yes	387767	+
3938	scaffold_3	397520	397556	36	4	no	NA	NA
3939	scaffold_3	400258	400743	485	67	no	NA	NA
3940	scaffold_3	401378	402412	1034	94	yes	307908	+
3941	scaffold_3	403630	404944	1314	150	yes	307909	-
3942	scaffold_3	406778	407801	1023	98	yes	404908	-
3943	scaffold_3	413414	414816	1402	86	yes	93443	+
3944	scaffold_3	419203	419557	354	28	yes	307910	-
3945	scaffold_3	425947	427047	1100	83	yes	307913	+
3946	scaffold_3	428828	430120	1292	119	yes	93458,307914	-,+
3947	scaffold_3	435717	437108	1391	121	yes	307916	-
3948	scaffold_3	440591	441710	1119	72	yes	307918	-
3949	scaffold_3	442308	443117	809	72	yes	387776	+
3950	scaffold_3	448443	450263	1820	213	no	NA	NA
3951	scaffold_3	456562	456567	5	4	yes	307922	+
3952	scaffold_3	480321	481588	1267	140	yes	373977	-
3953	scaffold_3	520842	520863	21	4	no	NA	NA
3954	scaffold_3	521037	522200	1163	134	no	NA	NA
3955	scaffold_3	525985	526015	30	6	no	NA	NA
3956	scaffold_3	526169	526894	725	86	yes	93692	-
3957	scaffold_3	537996	539439	1443	229	yes	307954	+
3958	scaffold_3	560024	561367	1343	105	yes	307965	+
3959	scaffold_3	588655	590276	1621	174	no	NA	NA
3960	scaffold_3	597231	598594	1363	109	yes	404949	+
3961	scaffold_3	598702	598757	55	5	no	NA	NA
3962	scaffold_3	603785	604719	934	107	yes	307981	+
3963	scaffold_3	634568	636246	1678	155	no	NA	NA
3964	scaffold_3	652995	656038	3043	376	no	NA	NA
3965	scaffold_3	665655	666990	1335	173	yes	307993	+
3966	scaffold_3	670413	671932	1519	155	yes	240521	+
3967	scaffold_3	678644	679887	1243	161	yes	240523	-
3968	scaffold_3	688026	689240	1214	169	yes	308005	+
3969	scaffold_3	691399	692501	1102	94	yes	94070	+
3970	scaffold_3	706615	707942	1327	127	yes	289500	-
3971	scaffold_3	711771	711964	193	18	yes	308020	+
3972	scaffold_3	712252	712600	348	26	no	NA	NA
3973	scaffold_3	714717	716128	1411	155	yes	404969	+
3974	scaffold_3	722963	723729	766	81	yes	240530,421171	-,+
3975	scaffold_3	732066	732939	873	101	yes	308028	-
3976	scaffold_3	733832	735133	1301	164	yes	308032	-
3977	scaffold_3	738709	739954	1245	150	yes	387816	-
3978	scaffold_3	744376	745203	827	65	no	NA	NA
3979	scaffold_3	758023	758955	932	119	yes	308038	+
3980	scaffold_3	761070	762311	1241	111	no	NA	NA
3981	scaffold_3	763243	764454	1211	140	yes	308041	-
3982	scaffold_3	765165	766334	1169	157	yes	308043	+
3983	scaffold_3	767801	769078	1277	112	yes	308046	+
3984	scaffold_3	775458	776143	685	56	yes	308047	-
3985	scaffold_3	777200	778494	1294	161	yes	308048	+
3986	scaffold_3	780094	781143	1049	131	yes	387825	+
3987	scaffold_3	782222	783294	1072	142	yes	308055	+
3988	scaffold_3	786030	787426	1396	167	yes	308060,421185	-,+
3989	scaffold_3	787613	788437	824	107	yes	308060,421185	-,+
3990	scaffold_3	788516	788607	91	9	no	NA	NA
3991	scaffold_3	792233	793754	1521	169	yes	94352	+
3992	scaffold_3	795422	796787	1365	153	yes	404991	+
3993	scaffold_3	801577	802428	851	122	yes	421187	-
3994	scaffold_3	806613	808155	1542	166	yes	289526	+
3995	scaffold_3	813428	814826	1398	148	yes	94450	+
3996	scaffold_3	819451	821430	1979	160	yes	404995	+
3997	scaffold_3	828497	829472	975	107	yes	308077	-
3998	scaffold_3	858768	859499	731	50	no	NA	NA
3999	scaffold_3	877109	878205	1096	150	yes	94550	+
4000	scaffold_3	884669	885939	1270	149	yes	421198	-
4001	scaffold_3	887289	888487	1198	154	yes	308094,387841	+,-
4002	scaffold_3	889528	890259	731	44	yes	308098	+
4003	scaffold_3	905156	906397	1241	108	yes	94641	-
4004	scaffold_3	914110	915126	1016	143	yes	308111	-
4005	scaffold_3	919008	920400	1392	130	yes	308117	-
4006	scaffold_3	925431	926340	909	79	yes	308122	-
4007	scaffold_3	930552	931677	1125	98	yes	308126,308128	-,+
4008	scaffold_3	932020	933150	1130	120	yes	308126,308128	-,+
4009	scaffold_3	935896	937019	1123	97	yes	308130	+
4010	scaffold_3	939468	940608	1140	155	yes	421211	-
4011	scaffold_3	948848	949792	944	82	yes	308136	-
4012	scaffold_3	951903	951926	23	8	no	NA	NA
4013	scaffold_3	955510	956370	860	78	yes	94772,308140	+,-
4014	scaffold_3	956536	957304	768	96	yes	94772,308140	+,-
4015	scaffold_3	957994	958000	6	3	no	NA	NA
4016	scaffold_3	959983	961203	1220	152	yes	308144,374045	+,+
4017	scaffold_3	961412	962266	854	106	yes	374045	+
4018	scaffold_3	972425	973503	1078	129	yes	308150,387861	-,+
4019	scaffold_3	976856	978432	1576	196	yes	308152	-
4020	scaffold_3	997027	998428	1401	164	yes	421222	-
4021	scaffold_3	1015585	1016445	860	99	yes	289569	+
4022	scaffold_3	1026541	1027527	986	92	yes	94898	+
4023	scaffold_3	1027665	1027701	36	6	no	NA	NA
4024	scaffold_3	1071784	1072571	787	85	yes	308180	+
4025	scaffold_3	1107052	1107408	356	25	yes	387883	-
4026	scaffold_3	1118985	1120370	1385	154	yes	308181	+
4027	scaffold_3	1126421	1127745	1324	121	yes	289593	-
4028	scaffold_3	1132606	1133371	765	71	no	NA	NA
4029	scaffold_3	1144847	1145801	954	137	yes	227984	-
4030	scaffold_3	1154479	1154495	16	4	no	NA	NA
4031	scaffold_3	1155068	1156635	1567	164	no	NA	NA
4032	scaffold_3	1157819	1157826	7	4	no	NA	NA
4033	scaffold_3	1158185	1159685	1500	173	yes	308207	-
4034	scaffold_3	1161204	1162545	1341	185	yes	289600	+
4035	scaffold_3	1172794	1174221	1427	116	yes	308210	-
4036	scaffold_3	1179980	1181740	1760	174	yes	421255	+
4037	scaffold_3	1196406	1196907	501	70	yes	308214	+
4038	scaffold_3	1198995	1199437	442	42	yes	421258	+
4039	scaffold_3	1202182	1203331	1149	132	yes	308215	+
4040	scaffold_3	1225718	1226639	921	78	yes	95248	+
4041	scaffold_3	1264667	1264691	24	6	yes	387908	+
4042	scaffold_3	1264930	1265682	752	57	yes	387908	+
4043	scaffold_3	1284805	1284817	12	4	yes	308222	+
4044	scaffold_3	1285233	1285249	16	4	yes	308222	+
4045	scaffold_3	1286775	1287151	376	46	no	NA	NA
4046	scaffold_3	1287247	1287425	178	26	no	NA	NA
4047	scaffold_3	1287659	1287912	253	26	no	NA	NA
4048	scaffold_3	1292869	1293751	882	132	no	NA	NA
4049	scaffold_3	1294156	1295213	1057	100	yes	387910	-
4050	scaffold_3	1295414	1296073	659	64	no	NA	NA
4051	scaffold_3	1305046	1306499	1453	148	yes	387912	-
4052	scaffold_3	1307184	1308228	1044	118	yes	308229	-
4053	scaffold_3	1310283	1311786	1503	141	yes	421276	+
4054	scaffold_3	1317244	1318631	1387	131	yes	308232	+
4055	scaffold_3	1320739	1320758	19	4	no	NA	NA
4056	scaffold_3	1320975	1321759	784	73	yes	95415	-
4057	scaffold_3	1327220	1328163	943	108	yes	308238	-
4058	scaffold_3	1331544	1332727	1183	160	yes	308240,387921	-,+
4059	scaffold_3	1333061	1334780	1719	152	yes	308240,387921	-,+
4060	scaffold_3	1335309	1336819	1510	164	no	NA	NA
4061	scaffold_3	1347155	1347166	11	4	yes	421284	+
4062	scaffold_3	1357016	1357794	778	98	yes	308250,308252	-,+
4063	scaffold_3	1358055	1359025	970	126	yes	308250,308252	-,+
4064	scaffold_3	1368540	1368567	27	3	no	NA	NA
4065	scaffold_3	1368639	1370253	1614	167	yes	405125	-
4066	scaffold_3	1380451	1381450	999	84	no	NA	NA
4067	scaffold_3	1411870	1413044	1174	110	yes	289659,387937	-,-
4068	scaffold_3	1414594	1416209	1615	126	yes	214286	+
4069	scaffold_3	1422161	1423016	855	90	yes	421297	+
4070	scaffold_3	1423549	1423555	6	4	no	NA	NA
4071	scaffold_3	1426606	1426722	116	17	yes	289663	+
4072	scaffold_3	1426914	1427185	271	40	no	NA	NA
4073	scaffold_3	1428565	1429928	1363	190	yes	308283	+
4074	scaffold_3	1440203	1440216	13	4	no	NA	NA
4075	scaffold_3	1440328	1440482	154	22	no	NA	NA
4076	scaffold_3	1441161	1442335	1174	150	yes	214220	+
4077	scaffold_3	1447079	1447113	34	10	no	NA	NA
4078	scaffold_3	1458359	1459492	1133	77	yes	213903	+
4079	scaffold_3	1463689	1464980	1291	130	yes	308296,421303	+,-
4080	scaffold_3	1469209	1470325	1116	82	yes	405144	+
4081	scaffold_3	1474471	1475574	1103	95	yes	421305	+
4082	scaffold_3	1482073	1482239	166	12	yes	405147	-
4083	scaffold_3	1495861	1497043	1182	109	yes	308304	+
4084	scaffold_3	1501730	1503245	1515	193	no	NA	NA
4085	scaffold_3	1507481	1508758	1277	157	yes	95920	-
4086	scaffold_3	1514154	1515446	1292	181	no	NA	NA
4087	scaffold_3	1518045	1519067	1022	137	yes	308313	+
4088	scaffold_3	1527584	1528137	553	50	no	NA	NA
4089	scaffold_3	1534128	1535421	1293	154	yes	308319	+
4090	scaffold_3	1538469	1539454	985	91	yes	308324	-
4091	scaffold_3	1549220	1550348	1128	141	yes	308328	-
4092	scaffold_3	1562171	1563524	1353	130	yes	213901	-
4093	scaffold_3	1569296	1569447	151	16	yes	387963	+
4094	scaffold_3	1576892	1578067	1175	62	yes	308334	+
4095	scaffold_3	1578337	1578344	7	4	no	NA	NA
4096	scaffold_3	1586867	1587624	757	78	yes	405171,421324	+,-
4097	scaffold_3	1587749	1588456	707	52	yes	405171,421324	+,-
4098	scaffold_3	1589314	1591582	2268	220	yes	289694,405173	+,+
4099	scaffold_3	1599587	1600664	1077	132	yes	405177	-
4100	scaffold_3	1603380	1604348	968	128	yes	421327	+
4101	scaffold_3	1605741	1605924	183	23	yes	96139	+
4102	scaffold_3	1606044	1606455	411	31	yes	96139	+
4103	scaffold_3	1606567	1606623	56	4	no	NA	NA
4104	scaffold_3	1609194	1610347	1153	105	yes	308355,308357	-,+
4105	scaffold_3	1620344	1621605	1261	144	yes	308360,308361	-,+
4106	scaffold_3	1621773	1622775	1002	131	yes	308360,308361	-,+
4107	scaffold_3	1622916	1622928	12	4	no	NA	NA
4108	scaffold_3	1626784	1626796	12	6	no	NA	NA
4109	scaffold_3	1629578	1631061	1483	173	yes	96180	-
4110	scaffold_3	1636591	1637476	885	97	yes	308368	-
4111	scaffold_3	1640291	1641411	1120	108	yes	308370	+
4112	scaffold_3	1644822	1646111	1289	130	yes	96233	-
4113	scaffold_3	1648342	1649321	979	126	yes	308380	+
4114	scaffold_3	1651530	1651541	11	4	yes	308383	+
4115	scaffold_3	1651984	1653039	1055	121	yes	308383	+
4116	scaffold_3	1659709	1661011	1302	178	no	NA	NA
4117	scaffold_3	1666233	1667387	1154	140	yes	308397	+
4118	scaffold_3	1673565	1674375	810	75	yes	421343	-
4119	scaffold_3	1687930	1687944	14	6	yes	421346	-
4120	scaffold_3	1697704	1698398	694	57	yes	308406	+
4121	scaffold_3	1704914	1706265	1351	147	yes	289722	-
4122	scaffold_3	1710426	1711183	757	72	yes	308408	-
4123	scaffold_3	1716719	1718258	1539	183	yes	421351	-
4124	scaffold_3	1752699	1753464	765	102	yes	308449,405220	-,+
4125	scaffold_3	1769288	1770777	1489	163	yes	421357	-
4126	scaffold_3	1772830	1774016	1186	144	yes	308456	+
4127	scaffold_3	1788435	1789486	1051	122	yes	308464,421360	+,-
4128	scaffold_3	1791081	1792268	1187	108	yes	289737	+
4129	scaffold_3	1792408	1792435	27	6	yes	289737	+
4130	scaffold_3	1817879	1819027	1148	100	yes	228072	-
4131	scaffold_3	1827120	1828303	1183	140	yes	308476	-
4132	scaffold_3	1828613	1829557	944	114	yes	308476	-
4133	scaffold_3	1834162	1835013	851	46	no	NA	NA
4134	scaffold_3	1839974	1841143	1169	156	yes	308479	+
4135	scaffold_3	1841377	1841392	15	4	no	NA	NA
4136	scaffold_3	1841936	1843084	1148	150	yes	388013	+
4137	scaffold_3	1847313	1847335	22	4	no	NA	NA
4138	scaffold_3	1847440	1848421	981	117	yes	308486	-
4139	scaffold_3	1853443	1853458	15	4	no	NA	NA
4140	scaffold_3	1853578	1855216	1638	201	yes	289750	-
4141	scaffold_3	1857610	1858831	1221	147	yes	308492	+
4142	scaffold_3	1860127	1861512	1385	147	yes	388017	+
4143	scaffold_3	1879259	1880844	1585	145	yes	308499	+
4144	scaffold_3	1927858	1928689	831	72	yes	405251	-
4145	scaffold_3	1931656	1932970	1314	209	yes	97073,365057	+,+
4146	scaffold_3	1944905	1947057	2152	239	yes	308513,421385	+,-
4147	scaffold_3	1952591	1953669	1078	142	yes	405257	-
4148	scaffold_3	1958047	1958056	9	4	no	NA	NA
4149	scaffold_3	1958253	1959354	1101	139	yes	308521	-
4150	scaffold_3	1959710	1959746	36	3	yes	308521	-
4151	scaffold_3	1961355	1962285	930	80	yes	308525	+
4152	scaffold_3	1967761	1968994	1233	109	yes	308529	-
4153	scaffold_3	1969732	1970945	1213	151	yes	97219	+
4154	scaffold_3	1975112	1976272	1160	115	yes	308534,421392	-,+
4155	scaffold_3	1976545	1977348	803	117	yes	308534,421392	-,+
4156	scaffold_3	2027293	2028580	1287	154	no	NA	NA
4157	scaffold_3	2040306	2041528	1222	122	no	NA	NA
4158	scaffold_3	2049154	2050923	1769	210	yes	365061	+
4159	scaffold_3	2060309	2061435	1126	143	yes	97351	-
4160	scaffold_3	2069331	2070447	1116	117	yes	405277	+
4161	scaffold_3	2082591	2084263	1672	198	yes	213945	-
4162	scaffold_3	2085727	2086834	1107	138	yes	308562	-
4163	scaffold_3	2095327	2096654	1327	152	no	NA	NA
4164	scaffold_3	2123532	2124573	1041	99	yes	308576	+
4165	scaffold_3	2127963	2128143	180	8	no	NA	NA
4166	scaffold_3	2128243	2129388	1145	147	yes	405289	-
4167	scaffold_3	2130203	2130930	727	59	yes	308580	+
4168	scaffold_3	2136861	2137864	1003	142	yes	421414	-
4169	scaffold_3	2141053	2142473	1420	144	yes	405292	+
4170	scaffold_3	2150213	2151113	900	129	yes	374252,405297	-,+
4171	scaffold_3	2151301	2152876	1575	201	yes	374252,405297	-,+
4172	scaffold_3	2156600	2157542	942	67	no	NA	NA
4173	scaffold_3	2163464	2164289	825	106	yes	308601	+
4174	scaffold_3	2170227	2171476	1249	142	yes	289804	+
4175	scaffold_3	2178019	2179331	1312	140	no	NA	NA
4176	scaffold_3	2181423	2182358	935	123	yes	388067	-
4177	scaffold_3	2184023	2185131	1108	145	yes	308609	+
4178	scaffold_3	2190182	2191396	1214	109	no	NA	NA
4179	scaffold_3	2193760	2194923	1163	153	yes	308615	+
4180	scaffold_3	2202755	2204157	1402	194	yes	97665,365064	+,+
4181	scaffold_3	2208272	2209218	946	131	yes	308624	+
4182	scaffold_3	2217314	2218608	1294	167	yes	308627	-
4183	scaffold_3	2221022	2222022	1000	115	yes	308631	-
4184	scaffold_3	2224561	2226015	1454	141	yes	289814	-
4185	scaffold_3	2241800	2241807	7	4	no	NA	NA
4186	scaffold_3	2241955	2242398	443	49	no	NA	NA
4187	scaffold_3	2253644	2255663	2019	210	no	NA	NA
4188	scaffold_3	2261061	2261796	735	89	yes	308642	-
4189	scaffold_3	2268686	2270223	1537	147	yes	308643	+
4190	scaffold_3	2280526	2281504	978	116	yes	308644	-
4191	scaffold_3	2290428	2291558	1130	123	yes	308649	-
4192	scaffold_3	2291878	2292965	1087	141	yes	308649,421436	-,+
4193	scaffold_3	2296240	2297933	1693	182	yes	289829	+
4194	scaffold_3	2305244	2306117	873	112	yes	308654	-
4195	scaffold_3	2306364	2307874	1510	170	yes	308654,421439	-,-
4196	scaffold_3	2308060	2308829	769	121	yes	421439,240765	-,+
4197	scaffold_3	2308968	2309024	56	12	no	NA	NA
4198	scaffold_3	2312967	2314478	1511	150	yes	308660	-
4199	scaffold_3	2315608	2316874	1266	116	yes	308661	+
4200	scaffold_3	2317185	2317191	6	3	no	NA	NA
4201	scaffold_3	2324341	2325289	948	122	yes	213864	-
4202	scaffold_3	2329034	2330530	1496	129	yes	308667	-
4203	scaffold_3	2334327	2334354	27	3	yes	98041	-
4204	scaffold_3	2339101	2340570	1469	106	yes	421446	-
4205	scaffold_3	2347489	2348594	1105	133	yes	308677	+
4206	scaffold_3	2349583	2350118	535	61	yes	421449	+
4207	scaffold_3	2350238	2350630	392	40	no	NA	NA
4208	scaffold_3	2350794	2351979	1185	139	yes	228156	+
4209	scaffold_3	2358396	2359666	1270	172	yes	214103	-
4210	scaffold_3	2391296	2392462	1166	148	yes	240795	-
4211	scaffold_3	2394096	2395100	1004	85	yes	98147	-
4212	scaffold_3	2409437	2410069	632	72	no	NA	NA
4213	scaffold_3	2410167	2410208	41	8	no	NA	NA
4214	scaffold_3	2420595	2421567	972	96	yes	98159	-
4215	scaffold_3	2423834	2424753	919	122	yes	308705,308707	-,+
4216	scaffold_3	2424973	2426097	1124	124	yes	308705,308707	-,+
4217	scaffold_3	2426452	2426472	20	4	no	NA	NA
4218	scaffold_3	2427064	2428085	1021	122	yes	308709	+
4219	scaffold_3	2436417	2436802	385	22	yes	308714	-
4220	scaffold_3	2441820	2443483	1663	207	yes	308716	+
4221	scaffold_3	2450011	2450589	578	49	yes	98257	+
4222	scaffold_3	2450795	2450804	9	4	no	NA	NA
4223	scaffold_3	2460641	2461442	801	87	yes	421469	+
4224	scaffold_3	2467441	2467453	12	6	yes	421471	+
4225	scaffold_3	2467565	2467806	241	26	yes	421471	+
4226	scaffold_3	2467944	2468650	706	58	no	NA	NA
4227	scaffold_3	2469966	2470173	207	27	no	NA	NA
4228	scaffold_3	2480757	2481870	1113	122	yes	405362	+
4229	scaffold_3	2493742	2495201	1459	134	no	NA	NA
4230	scaffold_3	2505608	2506548	940	119	yes	98365	+
4231	scaffold_3	2513005	2513959	954	79	yes	308739	-
4232	scaffold_3	2516282	2517674	1392	127	yes	421477	+
4233	scaffold_3	2520960	2520993	33	4	no	NA	NA
4234	scaffold_3	2521180	2522449	1269	141	yes	308742	-
4235	scaffold_3	2523277	2524095	818	103	no	NA	NA
4236	scaffold_3	2524278	2525634	1356	132	yes	308749	-
4237	scaffold_3	2525929	2527223	1294	138	yes	308749,228193	-,+
4238	scaffold_3	2529258	2530560	1302	156	yes	308752	-
4239	scaffold_3	2531129	2531196	67	10	no	NA	NA
4240	scaffold_3	2537062	2538861	1799	151	no	NA	NA
4241	scaffold_3	2554005	2554077	72	7	no	NA	NA
4242	scaffold_3	2554162	2555698	1536	161	yes	289881	-
4243	scaffold_3	2568182	2568764	582	41	no	NA	NA
4244	scaffold_23	15570	15609	39	12	no	NA	NA
4245	scaffold_23	18744	18762	18	8	no	NA	NA
4246	scaffold_23	19237	19256	19	6	no	NA	NA
4247	scaffold_23	81461	82470	1009	111	yes	319981,319983	+,+
4248	scaffold_23	124658	124700	42	6	no	NA	NA
4249	scaffold_23	167910	168744	834	99	no	NA	NA
4250	scaffold_23	168818	168865	47	8	no	NA	NA
4251	scaffold_23	170846	171198	352	57	no	NA	NA
4252	scaffold_23	175986	176469	483	57	no	NA	NA
4253	scaffold_23	216277	217503	1226	139	yes	319998,320000	-,+
4254	scaffold_23	217800	219093	1293	148	yes	319998,320000	-,+
4255	scaffold_23	223310	224813	1503	92	yes	404461	-
4256	scaffold_23	228847	230024	1177	110	yes	320005	+
4257	scaffold_23	236936	237698	762	52	yes	404463	-
4258	scaffold_23	240230	240249	19	6	no	NA	NA
4259	scaffold_23	241261	242661	1400	177	yes	320020	+
4260	scaffold_23	245308	246297	989	126	yes	320025,425821	+,-
4261	scaffold_23	246523	247529	1006	102	yes	320025,425821	+,-
4262	scaffold_23	247700	247718	18	6	no	NA	NA
4263	scaffold_23	253171	254828	1657	144	no	NA	NA
4264	scaffold_23	263863	265130	1267	162	yes	219116	+
4265	scaffold_23	268696	269675	979	92	yes	320034	+
4266	scaffold_23	269835	269917	82	8	no	NA	NA
4267	scaffold_23	271845	272718	873	99	yes	320037	-
4268	scaffold_23	273117	273136	19	4	yes	320037	-
4269	scaffold_23	275993	276881	888	92	yes	320039	-
4270	scaffold_23	284755	284783	28	3	no	NA	NA
4271	scaffold_23	298994	300451	1457	174	no	NA	NA
4272	scaffold_23	309671	310321	650	37	yes	365786	+
4273	scaffold_23	316310	317344	1034	94	yes	320045,404482	+,-
4274	scaffold_23	317673	318794	1121	113	yes	320045	+
4275	scaffold_23	321617	322475	858	111	yes	320047	+
4276	scaffold_23	333409	334734	1325	129	yes	404486	+
4277	scaffold_23	342082	343364	1282	124	yes	404488	-
4278	scaffold_23	344090	345059	969	142	yes	320060	+
4279	scaffold_23	363530	364056	526	42	yes	320065	+
4280	scaffold_23	366222	367210	988	110	yes	320069	-
4281	scaffold_23	368581	370092	1511	162	yes	77802	-
4282	scaffold_23	370485	370879	394	26	no	NA	NA
4283	scaffold_23	372002	372863	861	83	yes	320077	+
4284	scaffold_23	374941	376644	1703	191	yes	320080	+
4285	scaffold_23	396580	397783	1203	156	yes	320086,320088	-,+
4286	scaffold_23	398029	399025	996	101	yes	320086,320088	-,+
4287	scaffold_23	408347	409775	1428	167	yes	404502	-
4288	scaffold_23	411560	413232	1672	172	yes	320091	+
4289	scaffold_23	413551	414215	664	88	yes	295082	+
4290	scaffold_23	426621	427725	1104	149	yes	385556	-
4291	scaffold_23	429333	430724	1391	182	yes	425854	+
4292	scaffold_23	436167	437277	1110	103	yes	425855	-
4293	scaffold_23	441346	441376	30	8	no	NA	NA
4294	scaffold_23	441524	442102	578	60	yes	320100	-
4295	scaffold_23	450789	451551	762	87	yes	78050	+
4296	scaffold_23	456748	457829	1081	153	yes	320104	-
4297	scaffold_23	458021	459381	1360	137	yes	320104,320105	-,-
4298	scaffold_23	459740	459750	10	4	yes	320105	-
4299	scaffold_23	463213	464043	830	108	yes	320109	-
4300	scaffold_23	464232	465943	1711	187	yes	320109	-
4301	scaffold_23	467379	467905	526	38	yes	320111	+
4302	scaffold_23	469876	471097	1221	147	yes	320113	-
4303	scaffold_23	471162	471431	269	35	yes	320113	-
4304	scaffold_23	473791	474981	1190	87	yes	392487	-
4305	scaffold_23	475791	477240	1449	137	yes	78082	-
4306	scaffold_23	486605	486755	150	8	yes	320120	-
4307	scaffold_23	486921	486943	22	10	yes	320120	-
4308	scaffold_23	505798	507151	1353	101	yes	295103	-
4309	scaffold_23	509160	509188	28	6	no	NA	NA
4310	scaffold_23	523013	523709	696	51	no	NA	NA
4311	scaffold_23	526017	526392	375	24	no	NA	NA
4312	scaffold_23	531310	531836	526	59	yes	425876	-
4313	scaffold_23	533437	534014	577	60	yes	320131	-
4314	scaffold_23	537329	538526	1197	155	yes	295110	-
4315	scaffold_23	544792	545685	893	76	yes	404538	-
4316	scaffold_23	546825	548090	1265	145	no	NA	NA
4317	scaffold_23	551026	551987	961	66	yes	320138	-
4318	scaffold_23	556156	557528	1372	69	yes	320139	+
4319	scaffold_23	566013	567605	1592	163	yes	219065	-
4320	scaffold_23	570122	571599	1477	167	yes	404542	-
4321	scaffold_23	574574	575588	1014	84	yes	392505	-
4322	scaffold_23	578729	579378	649	105	no	NA	NA
4323	scaffold_23	587386	588572	1186	110	yes	219037	-
4324	scaffold_23	590352	591501	1149	139	yes	320149	-
4325	scaffold_23	593475	594619	1144	142	yes	320154	-
4326	scaffold_23	595042	596511	1469	185	yes	320154,320157	-,-
4327	scaffold_23	599108	600107	999	120	yes	320159	-
4328	scaffold_23	614133	615160	1027	148	no	NA	NA
4329	scaffold_23	629288	629896	608	79	yes	320233	-
4330	scaffold_23	635224	636383	1159	134	yes	78449	+
4331	scaffold_23	646083	647243	1160	106	yes	320248	-
4332	scaffold_23	650384	651721	1337	200	yes	392521	-
4333	scaffold_23	652420	653444	1024	115	yes	320252	+
4334	scaffold_23	658060	659439	1379	104	yes	320254	-
4335	scaffold_23	660723	662405	1682	198	yes	404565	+
4336	scaffold_23	670083	670315	232	30	no	NA	NA
4337	scaffold_23	670604	671105	501	44	yes	320257	-
4338	scaffold_23	681008	682467	1459	82	no	NA	NA
4339	scaffold_23	689870	689885	15	4	no	NA	NA
4340	scaffold_23	690258	690975	717	123	yes	320263	-
4341	scaffold_23	693003	693101	98	3	no	NA	NA
4342	scaffold_23	696851	698201	1350	103	yes	320266	+
4343	scaffold_23	698790	699398	608	67	no	NA	NA
4344	scaffold_23	703292	704155	863	117	yes	245071	-
4345	scaffold_23	710188	711379	1191	128	yes	320274	-
4346	scaffold_23	718443	719474	1031	109	yes	320278	+
4347	scaffold_23	723228	723365	137	8	yes	404575	+
4348	scaffold_23	728239	728437	198	12	yes	392534	-
4349	scaffold_23	744818	744826	8	4	no	NA	NA
4350	scaffold_23	769468	769798	330	10	no	NA	NA
4351	scaffold_23	770292	770690	398	28	yes	295161	+
4352	scaffold_23	776596	776755	159	12	no	NA	NA
4353	scaffold_23	777052	777256	204	19	yes	320373	-
4354	scaffold_23	791216	791323	107	11	yes	320378	+
4355	scaffold_23	795123	795670	547	84	no	NA	NA
4356	scaffold_23	796097	796104	7	4	no	NA	NA
4357	scaffold_23	796205	796649	444	53	yes	320380	-
4358	scaffold_23	807523	807538	15	4	yes	404599	-
4359	scaffold_23	807658	807664	6	4	yes	404599	-
4360	scaffold_23	807837	808926	1089	152	yes	404599	-
4361	scaffold_23	811464	812183	719	109	yes	372495	+
4362	scaffold_23	823358	824125	767	83	yes	245082	-
4363	scaffold_23	832275	832923	648	57	yes	404605	+
4364	scaffold_23	833060	833100	40	8	no	NA	NA
4365	scaffold_23	840013	841916	1903	213	yes	425940	+
4366	scaffold_23	848236	849525	1289	172	yes	78981	-
4367	scaffold_23	855746	857331	1585	134	yes	320403	+
4368	scaffold_23	868042	869961	1919	221	yes	385563	-
4369	scaffold_23	872684	873328	644	57	yes	320413	-
4370	scaffold_23	875076	875291	215	30	no	NA	NA
4371	scaffold_23	875395	875451	56	18	no	NA	NA
4372	scaffold_23	875618	875776	158	20	no	NA	NA
4373	scaffold_23	879934	879994	60	18	yes	392566	-
4374	scaffold_23	886112	887063	951	101	yes	392567	-
4375	scaffold_23	904959	905478	519	50	no	NA	NA
4376	scaffold_23	919853	920954	1101	140	yes	295188	-
4377	scaffold_23	922960	923301	341	67	no	NA	NA
4378	scaffold_23	924384	924985	601	88	yes	425950	-
4379	scaffold_23	928414	928438	24	4	yes	219064	-
4380	scaffold_23	928527	929633	1106	133	yes	219064	-
4381	scaffold_23	935120	935144	24	4	no	NA	NA
4382	scaffold_23	935460	936424	964	140	yes	425952	-
4383	scaffold_23	936931	938200	1269	147	yes	425952,392574	-,+
4384	scaffold_23	939857	940544	687	90	yes	320451	-
4385	scaffold_23	940880	941998	1118	114	yes	320451,320454,320458	-,-,+
4386	scaffold_23	942207	943028	821	78	yes	320454,320458	-,+
4387	scaffold_23	945082	945992	910	110	yes	320463	-
4388	scaffold_23	957030	957839	809	76	yes	320466	-
4389	scaffold_23	960863	962093	1230	146	yes	320468	-
4390	scaffold_23	966633	967655	1022	58	yes	320470	+
4391	scaffold_23	967784	967845	61	5	no	NA	NA
4392	scaffold_23	970193	970212	19	6	yes	404639	+
4393	scaffold_23	970499	970932	433	39	yes	404639	+
4394	scaffold_23	980460	982255	1795	166	yes	295204	-
4395	scaffold_23	986984	988642	1658	158	yes	404642	-
4396	scaffold_23	1009686	1010565	879	77	yes	79438	-
4397	scaffold_23	1031718	1032924	1206	183	yes	219139	-
4398	scaffold_23	1033536	1033923	387	51	no	NA	NA
4399	scaffold_23	1050111	1051262	1151	88	yes	404654	-
4400	scaffold_23	1058547	1060083	1536	183	no	NA	NA
4401	scaffold_23	1061220	1061955	735	68	yes	320496	-
4402	scaffold_23	1063068	1064322	1254	123	yes	295219	-
4403	scaffold_23	1074366	1075005	639	76	no	NA	NA
4404	scaffold_4	7252	7261	9	4	no	NA	NA
4405	scaffold_4	7402	7578	176	21	no	NA	NA
4406	scaffold_4	7773	7795	22	6	no	NA	NA
4407	scaffold_4	7936	8117	181	21	no	NA	NA
4408	scaffold_4	34696	34916	220	10	yes	376291	+
4409	scaffold_4	51937	53672	1735	197	yes	308774	-
4410	scaffold_4	66596	67723	1127	146	yes	308784,308787,421498	-,+,+
4411	scaffold_4	79312	79792	480	65	yes	116460	+
4412	scaffold_4	96794	97967	1173	164	yes	388150	-
4413	scaffold_4	101290	101299	9	4	no	NA	NA
4414	scaffold_4	101474	102216	742	84	yes	308803	-
4415	scaffold_4	106672	107581	909	84	yes	388152	-
4416	scaffold_4	111497	112389	892	95	yes	116522	+
4417	scaffold_4	124261	125058	797	101	yes	421508	+
4418	scaffold_4	141762	142560	798	75	no	NA	NA
4419	scaffold_4	153866	153885	19	4	no	NA	NA
4420	scaffold_4	153953	154683	730	78	yes	388158	-
4421	scaffold_4	161179	161974	795	85	yes	116645	-
4422	scaffold_4	165596	166918	1322	158	yes	388160	-
4423	scaffold_4	182326	183915	1589	193	yes	308855	+
4424	scaffold_4	184045	184068	23	6	no	NA	NA
4425	scaffold_4	185452	185524	72	13	yes	417269	-
4426	scaffold_4	185717	186202	485	46	yes	417269	-
4427	scaffold_4	194705	196064	1359	146	yes	388164	-
4428	scaffold_4	196275	196294	19	6	no	NA	NA
4429	scaffold_4	198214	199403	1189	124	yes	116761	-
4430	scaffold_4	200966	202247	1281	157	yes	308864	+
4431	scaffold_4	205699	207037	1338	173	yes	308865	-
4432	scaffold_4	211606	212906	1300	113	yes	417274	+
4433	scaffold_4	225212	226003	791	52	no	NA	NA
4434	scaffold_4	226367	227428	1061	103	yes	417277	+
4435	scaffold_4	227573	227579	6	4	yes	417277	+
4436	scaffold_4	235301	235800	499	67	yes	421529	-
4437	scaffold_4	236486	236506	20	6	no	NA	NA
4438	scaffold_4	242445	244000	1555	201	yes	388172	-
4439	scaffold_4	249208	250944	1736	213	yes	289924	-
4440	scaffold_4	264671	265259	588	44	yes	116931	+
4441	scaffold_4	265926	265957	31	5	no	NA	NA
4442	scaffold_4	276743	277906	1163	138	yes	308908	-
4443	scaffold_4	279199	280362	1163	158	yes	308909	-
4444	scaffold_4	281516	282609	1093	129	no	NA	NA
4445	scaffold_4	295821	296712	891	115	yes	308917,384908	+,-
4446	scaffold_4	297077	298176	1099	106	yes	308917,384908	+,-
4447	scaffold_4	298963	300365	1402	120	yes	308918	-
4448	scaffold_4	304473	305185	712	72	yes	421541	+
4449	scaffold_4	332613	333426	813	123	no	NA	NA
4450	scaffold_4	348285	348324	39	12	no	NA	NA
4451	scaffold_4	351431	351479	48	12	no	NA	NA
4452	scaffold_4	351958	351977	19	7	no	NA	NA
4453	scaffold_4	354923	355761	838	84	yes	388190	+
4454	scaffold_4	402478	403763	1285	103	yes	240867	-
4455	scaffold_4	432734	432740	6	4	yes	117151	+
4456	scaffold_4	435366	435668	302	47	no	NA	NA
4457	scaffold_4	440420	440501	81	16	yes	388196	-
4458	scaffold_4	453447	454781	1334	180	yes	421553	-
4459	scaffold_4	455771	457116	1345	178	yes	308947	-
4460	scaffold_4	458371	458379	8	4	no	NA	NA
4461	scaffold_4	532772	534144	1372	139	yes	117300	-
4462	scaffold_4	534554	535817	1263	146	yes	117300,421562	-,-
4463	scaffold_4	537478	538804	1326	146	yes	388203	-
4464	scaffold_4	542948	543908	960	78	yes	421564	-
4465	scaffold_4	544592	545507	915	115	yes	417347	-
4466	scaffold_4	548286	549300	1014	132	yes	308966	+
4467	scaffold_4	577938	578820	882	98	yes	308973,308978	-,-
4468	scaffold_4	586322	587503	1181	89	yes	308983	-
4469	scaffold_4	590889	592135	1246	122	yes	388213	+
4470	scaffold_4	600904	601561	657	47	yes	376419	-
4471	scaffold_4	602152	603800	1648	136	yes	240884,308993	+,+
4472	scaffold_4	604086	605029	943	89	yes	308993	+
4473	scaffold_4	608082	608695	613	36	yes	417359	-
4474	scaffold_4	610009	611606	1597	189	yes	308997	+
4475	scaffold_4	617704	618723	1019	118	yes	308999	+
4476	scaffold_4	626055	626857	802	86	no	NA	NA
4477	scaffold_4	627674	628604	930	73	yes	289984	+
4478	scaffold_4	631440	631486	46	14	yes	240903	+
4479	scaffold_4	632183	632542	359	42	no	NA	NA
4480	scaffold_4	633648	635004	1356	188	yes	421582	+
4481	scaffold_4	665419	665949	530	26	yes	309010	-
4482	scaffold_4	671425	671826	401	43	no	NA	NA
4483	scaffold_4	675095	676540	1445	159	yes	309015	+
4484	scaffold_4	681263	682580	1317	125	no	NA	NA
4485	scaffold_4	695483	696594	1111	103	yes	309024	+
4486	scaffold_4	701862	702819	957	93	yes	117664	+
4487	scaffold_4	706402	707198	796	102	yes	309033	+
4488	scaffold_4	709505	710668	1163	139	yes	214315	+
4489	scaffold_4	719952	722725	2773	329	yes	388236,421598	+,+
4490	scaffold_4	722960	723918	958	126	yes	421598	+
4491	scaffold_4	731145	731834	689	40	no	NA	NA
4492	scaffold_4	732166	732355	189	22	no	NA	NA
4493	scaffold_4	732629	732795	166	15	no	NA	NA
4494	scaffold_4	737176	737186	10	4	yes	290007	+
4495	scaffold_4	748246	749349	1103	130	yes	309047	+
4496	scaffold_4	762308	763409	1101	116	yes	417392	-
4497	scaffold_4	766051	766773	722	92	no	NA	NA
4498	scaffold_4	767236	767250	14	6	yes	309059	-
4499	scaffold_4	771591	772271	680	51	yes	240932	-
4500	scaffold_4	779652	780242	590	54	yes	421605	-
4501	scaffold_4	780437	782016	1579	162	yes	421605	-
4502	scaffold_4	786525	787601	1076	130	no	NA	NA
4503	scaffold_4	790221	790990	769	41	yes	309065	-
4504	scaffold_4	805506	806735	1229	152	no	NA	NA
4505	scaffold_4	812626	814096	1470	138	yes	290016	-
4506	scaffold_4	827932	829068	1136	104	yes	417403	-
4507	scaffold_4	837666	838844	1178	117	yes	117986	-
4508	scaffold_4	841330	841341	11	4	no	NA	NA
4509	scaffold_4	841647	842561	914	99	yes	309079,388252	+,-
4510	scaffold_4	842748	843561	813	83	yes	309079,388252	+,-
4511	scaffold_4	844658	846009	1351	99	yes	118027	+
4512	scaffold_4	851185	852272	1087	115	yes	240947	-
4513	scaffold_4	864471	865428	957	85	yes	309089	+
4514	scaffold_4	865546	865629	83	10	yes	309089	+
4515	scaffold_4	869092	870125	1033	99	yes	240954	+
4516	scaffold_4	872687	874197	1510	157	yes	240956	+
4517	scaffold_4	876010	877217	1207	159	yes	309092	+
4518	scaffold_4	881460	883085	1625	180	yes	309093	-
4519	scaffold_4	885125	886196	1071	104	yes	417418	-
4520	scaffold_4	888085	889417	1332	164	yes	309096	+
4521	scaffold_4	895353	896856	1503	195	yes	309100	-
4522	scaffold_4	897364	898306	942	106	yes	309102	+
4523	scaffold_4	902705	903504	799	85	yes	421627	-
4524	scaffold_4	908868	909807	939	108	yes	214639	-
4525	scaffold_4	911076	912101	1025	116	no	NA	NA
4526	scaffold_4	921794	922353	559	50	yes	417426	+
4527	scaffold_4	929204	929446	242	17	yes	417427	+
4528	scaffold_4	936439	937237	798	86	yes	214318	-
4529	scaffold_4	937708	938270	562	49	no	NA	NA
4530	scaffold_4	941402	942656	1254	140	yes	240973	-
4531	scaffold_4	943867	945003	1136	67	yes	388275	+
4532	scaffold_4	948930	949520	590	66	yes	388276	+
4533	scaffold_4	953582	954547	965	125	yes	309138,309139	-,+
4534	scaffold_4	954817	956134	1317	125	yes	309138,309139	-,+
4535	scaffold_4	960938	962450	1512	150	yes	228352,309140	+,-
4536	scaffold_4	962743	963902	1159	117	yes	228352,309140	+,-
4537	scaffold_4	967509	968769	1260	126	yes	290054	-
4538	scaffold_4	973200	974745	1545	165	yes	309150	-
4539	scaffold_4	977144	977852	708	55	yes	118629	-
4540	scaffold_4	985637	986963	1326	118	yes	417440	-
4541	scaffold_4	987692	988573	881	97	yes	240985	-
4542	scaffold_4	988701	988717	16	4	yes	240985	-
4543	scaffold_4	993026	994295	1269	160	no	NA	NA
4544	scaffold_4	1007523	1007531	8	4	no	NA	NA
4545	scaffold_4	1009463	1009557	94	12	no	NA	NA
4546	scaffold_4	1020402	1021916	1514	166	yes	309170	-
4547	scaffold_4	1037598	1039137	1539	159	yes	309178	-
4548	scaffold_4	1041954	1043158	1204	117	yes	365100	+
4549	scaffold_4	1046490	1047652	1162	148	yes	309188	+
4550	scaffold_4	1056371	1057303	932	74	no	NA	NA
4551	scaffold_4	1060392	1060977	585	49	yes	290068	+
4552	scaffold_4	1063650	1064743	1093	99	yes	309192	+
4553	scaffold_4	1089545	1090884	1339	149	yes	309202,309204	-,+
4554	scaffold_4	1091127	1092992	1865	260	yes	309202,309204	-,+
4555	scaffold_4	1098805	1100119	1314	154	yes	417460	+
4556	scaffold_4	1114513	1115878	1365	176	yes	388300	-
4557	scaffold_4	1117594	1118661	1067	154	yes	290077	-
4558	scaffold_4	1119789	1120966	1177	125	yes	309213	-
4559	scaffold_4	1123999	1125539	1540	157	yes	309217	-
4560	scaffold_4	1129824	1131120	1296	102	yes	309227	-
4561	scaffold_4	1134950	1135758	808	79	yes	309229	-
4562	scaffold_4	1139008	1140610	1602	222	no	NA	NA
4563	scaffold_4	1146510	1146522	12	4	yes	309232	-
4564	scaffold_4	1146608	1146789	181	21	yes	309232	-
4565	scaffold_4	1146900	1146921	21	6	yes	309232	-
4566	scaffold_4	1151050	1152037	987	106	yes	421669	-
4567	scaffold_4	1154078	1154948	870	89	yes	309237	+
4568	scaffold_4	1155071	1155081	10	3	no	NA	NA
4569	scaffold_4	1172820	1173939	1119	138	yes	309248	-
4570	scaffold_4	1192754	1194409	1655	186	yes	309254	-
4571	scaffold_4	1204456	1204481	25	6	no	NA	NA
4572	scaffold_4	1206936	1208148	1212	134	yes	119256	-
4573	scaffold_4	1210627	1211897	1270	147	yes	309258	-
4574	scaffold_4	1212746	1213877	1131	94	yes	309260	+
4575	scaffold_4	1216225	1217196	971	65	yes	309261	-
4576	scaffold_4	1217977	1218948	971	133	yes	421682	+
4577	scaffold_4	1221565	1222912	1347	104	yes	119341	+
4578	scaffold_4	1229913	1230964	1051	128	yes	119353	-
4579	scaffold_4	1231915	1233620	1705	183	yes	309269	+
4580	scaffold_4	1249614	1250905	1291	187	yes	309276	-
4581	scaffold_4	1255912	1257048	1136	130	yes	309281	+
4582	scaffold_4	1266715	1267843	1128	111	yes	228409	-
4583	scaffold_4	1268596	1269136	540	50	no	NA	NA
4584	scaffold_4	1274560	1274978	418	19	yes	309291	-
4585	scaffold_4	1278840	1279670	830	83	no	NA	NA
4586	scaffold_4	1283419	1284771	1352	137	yes	309298	+
4587	scaffold_4	1287375	1288858	1483	192	yes	421693	+
4588	scaffold_4	1300793	1302018	1225	165	yes	309306	-
4589	scaffold_4	1309247	1312413	3166	369	no	NA	NA
4590	scaffold_4	1319165	1320747	1582	181	no	NA	NA
4591	scaffold_4	1320951	1320981	30	8	no	NA	NA
4592	scaffold_4	1327363	1328347	984	100	yes	388340	+
4593	scaffold_4	1334129	1335643	1514	204	yes	309311	+
4594	scaffold_4	1335763	1335770	7	4	no	NA	NA
4595	scaffold_4	1338001	1338611	610	89	yes	309313	+
4596	scaffold_4	1338723	1338726	3	3	no	NA	NA
4597	scaffold_4	1345903	1345930	27	6	no	NA	NA
4598	scaffold_4	1346086	1346858	772	128	yes	309315	-
4599	scaffold_4	1350352	1352005	1653	179	yes	376488	+
4600	scaffold_4	1356946	1358416	1470	143	no	NA	NA
4601	scaffold_4	1369944	1371268	1324	144	no	NA	NA
4602	scaffold_4	1380542	1381937	1395	148	yes	388350	-
4603	scaffold_4	1385746	1386576	830	74	yes	119650	+
4604	scaffold_4	1386851	1386871	20	5	no	NA	NA
4605	scaffold_4	1389182	1389230	48	6	yes	309330	+
4606	scaffold_4	1389708	1390612	904	75	yes	309330	+
4607	scaffold_4	1390764	1391088	324	30	no	NA	NA
4608	scaffold_4	1391354	1392820	1466	140	yes	309333,309336	-,+
4609	scaffold_4	1397880	1399326	1446	208	yes	119678	-
4610	scaffold_4	1405378	1406583	1205	129	yes	309342	+
4611	scaffold_4	1410548	1411981	1433	140	yes	309345,417520	+,-
4612	scaffold_4	1417587	1418836	1249	83	yes	119738	-
4613	scaffold_4	1440709	1442274	1565	187	yes	388358	-
4614	scaffold_4	1445658	1446617	959	102	yes	309353	-
4615	scaffold_4	1452449	1453419	970	175	yes	309354	-
4616	scaffold_4	1455508	1456554	1046	89	yes	417528	+
4617	scaffold_4	1459284	1459881	597	82	yes	309359	-
4618	scaffold_4	1470531	1470650	119	15	yes	421722	+
4619	scaffold_4	1472193	1473229	1036	114	yes	309371	-
4620	scaffold_4	1485185	1486571	1386	132	yes	290151	-
4621	scaffold_4	1487670	1488532	862	98	yes	241077	+
4622	scaffold_4	1494981	1494989	8	4	no	NA	NA
4623	scaffold_4	1495722	1497330	1608	212	yes	309387,365113	+,-
4624	scaffold_4	1500768	1502353	1585	192	yes	388375	-
4625	scaffold_4	1503870	1504794	924	94	yes	309390	+
4626	scaffold_4	1508585	1508602	17	4	yes	309393	-
4627	scaffold_4	1510596	1511894	1298	146	yes	309396	-
4628	scaffold_4	1512678	1513671	993	155	yes	309398	+
4629	scaffold_4	1520250	1521767	1517	161	yes	120154	-
4630	scaffold_4	1522473	1523592	1119	101	yes	309406	+
4631	scaffold_4	1527379	1528883	1504	155	yes	120225	-
4632	scaffold_4	1530419	1532004	1585	176	yes	417550	+
4633	scaffold_4	1542713	1543934	1221	160	yes	290169	+
4634	scaffold_4	1555622	1555829	207	26	yes	388390	-
4635	scaffold_4	1559050	1559188	138	20	yes	421744	-
4636	scaffold_4	1564588	1565772	1184	127	yes	388393	-
4637	scaffold_4	1566035	1566772	737	87	yes	388393	-
4638	scaffold_4	1574737	1574741	4	3	no	NA	NA
4639	scaffold_4	1574846	1575505	659	55	yes	421750	-
4640	scaffold_4	1576945	1576982	37	12	no	NA	NA
4641	scaffold_4	1586061	1587277	1216	169	yes	421752	+
4642	scaffold_4	1591858	1592883	1025	113	yes	309437	-
4643	scaffold_4	1595271	1596704	1433	151	yes	309441	+
4644	scaffold_4	1599482	1600675	1193	137	yes	309442	-
4645	scaffold_4	1605945	1606695	750	71	yes	120431,309445	+,+
4646	scaffold_4	1610272	1611640	1368	139	yes	417571	-
4647	scaffold_4	1612928	1612944	16	4	no	NA	NA
4648	scaffold_4	1614831	1616168	1337	190	yes	309448	-
4649	scaffold_4	1616492	1617777	1285	137	yes	309452	+
4650	scaffold_4	1623427	1624765	1338	156	yes	388407	-
4651	scaffold_4	1628945	1630348	1403	141	yes	120503,388408	+,-
4652	scaffold_4	1632665	1634002	1337	148	yes	309456	+
4653	scaffold_4	1642732	1644156	1424	148	yes	120515,421766	-,+
4654	scaffold_4	1644563	1645248	685	97	yes	421766	+
4655	scaffold_4	1653511	1654886	1375	172	no	NA	NA
4656	scaffold_4	1660695	1661601	906	119	no	NA	NA
4657	scaffold_4	1666211	1667330	1119	147	yes	388416	+
4658	scaffold_4	1672073	1672970	897	116	yes	309470	-
4659	scaffold_4	1673244	1674827	1583	172	yes	309470,417581	-,+
4660	scaffold_4	1695253	1696417	1164	137	no	NA	NA
4661	scaffold_4	1702189	1702587	398	15	yes	309478	+
4662	scaffold_4	1704814	1706214	1400	152	yes	214532	+
4663	scaffold_4	1721618	1722790	1172	97	yes	309484,309488	-,+
4664	scaffold_4	1723034	1724147	1113	116	yes	309484,309488	-,+
4665	scaffold_4	1727895	1728624	729	46	no	NA	NA
4666	scaffold_4	1730310	1731418	1108	94	yes	309492	-
4667	scaffold_4	1736158	1737823	1665	159	yes	421779	-
4668	scaffold_4	1741725	1743426	1701	231	yes	388431	-
4669	scaffold_4	1747469	1748629	1160	114	yes	309500	-
4670	scaffold_4	1753091	1753110	19	4	no	NA	NA
4671	scaffold_4	1753355	1755037	1682	158	yes	421782	-
4672	scaffold_4	1761869	1763921	2052	217	yes	309504	-
4673	scaffold_4	1768025	1769455	1430	122	yes	309506	-
4674	scaffold_4	1786638	1787572	934	71	no	NA	NA
4675	scaffold_4	1795323	1796845	1522	171	yes	120939,309512	+,+
4676	scaffold_4	1799376	1800376	1000	86	yes	309513	+
4677	scaffold_4	1804920	1806944	2024	213	yes	309515,309516	+,+
4678	scaffold_4	1807413	1807436	23	4	yes	309516	+
4679	scaffold_4	1807565	1808569	1004	71	yes	309516	+
4680	scaffold_4	1817114	1818086	972	108	yes	309521,421793	-,+
4681	scaffold_4	1818417	1819543	1126	102	yes	309521,421793	-,+
4682	scaffold_4	1821594	1822778	1184	147	yes	309526,309530	-,+
4683	scaffold_4	1823025	1824166	1141	111	yes	309526,309530	-,+
4684	scaffold_4	1825585	1826953	1368	145	yes	309532	+
4685	scaffold_14	14248	15279	1031	110	yes	198228	+
4686	scaffold_14	24190	26102	1912	204	yes	292938	-
4687	scaffold_14	28792	29605	813	94	yes	424035	+
4688	scaffold_14	31882	33115	1233	168	yes	292940,424036	+,+
4689	scaffold_14	40578	40969	391	35	yes	402586	+
4690	scaffold_14	43151	44697	1546	150	no	NA	NA
4691	scaffold_14	45247	46447	1200	121	yes	315177	+
4692	scaffold_14	55022	55032	10	3	no	NA	NA
4693	scaffold_14	55563	56096	533	46	yes	402590	+
4694	scaffold_14	59363	60338	975	117	yes	369466	-
4695	scaffold_14	60684	60697	13	4	yes	369466	-
4696	scaffold_14	61258	62420	1162	133	yes	38209	+
4697	scaffold_14	66698	68456	1758	184	yes	424045	+
4698	scaffold_14	81855	82761	906	70	yes	315194	-
4699	scaffold_14	88317	89261	944	118	no	NA	NA
4700	scaffold_14	99033	100430	1397	166	yes	315199	+
4701	scaffold_14	103002	104000	998	110	yes	315201	+
4702	scaffold_14	112197	113531	1334	145	yes	243230	-
4703	scaffold_14	117040	118621	1581	153	yes	38378,315212	-,+
4704	scaffold_14	119151	120227	1076	123	yes	315212	+
4705	scaffold_14	122669	124103	1434	155	yes	315216	+
4706	scaffold_14	132039	133131	1092	124	yes	390705	-
4707	scaffold_14	139998	141018	1020	111	yes	315222	-
4708	scaffold_14	141955	142945	990	96	yes	315224	+
4709	scaffold_14	144828	146078	1250	151	yes	315226	+
4710	scaffold_14	149006	150223	1217	144	yes	390709,424060	+,-
4711	scaffold_14	150480	151548	1068	106	yes	390709	+
4712	scaffold_14	154666	155716	1050	89	yes	424062	-
4713	scaffold_14	155908	157195	1287	118	yes	424062,390712	-,-
4714	scaffold_14	157954	158862	908	95	yes	315233	+
4715	scaffold_14	159062	159078	16	8	no	NA	NA
4716	scaffold_14	161276	161922	646	50	yes	292972	+
4717	scaffold_14	171682	172613	931	64	yes	315237	+
4718	scaffold_14	181272	181411	139	10	no	NA	NA
4719	scaffold_14	181642	182432	790	96	no	NA	NA
4720	scaffold_14	182686	184799	2113	271	yes	369479	-
4721	scaffold_14	186952	187574	622	76	yes	315255	-
4722	scaffold_14	189382	190739	1357	149	yes	402621	-
4723	scaffold_14	198617	199111	494	18	no	NA	NA
4724	scaffold_14	199691	200713	1022	77	yes	292979	+
4725	scaffold_14	207542	208137	595	56	yes	365514	+
4726	scaffold_14	212670	212739	69	11	no	NA	NA
4727	scaffold_14	212969	212977	8	3	yes	315275	+
4728	scaffold_14	228895	230033	1138	151	yes	402629	-
4729	scaffold_14	243215	243796	581	38	yes	292988	+
4730	scaffold_14	244055	244341	286	17	yes	292988	+
4731	scaffold_14	244427	244718	291	22	no	NA	NA
4732	scaffold_14	253654	253666	12	4	no	NA	NA
4733	scaffold_14	254180	254311	131	20	no	NA	NA
4734	scaffold_14	261197	261224	27	8	no	NA	NA
4735	scaffold_14	261589	261609	20	6	no	NA	NA
4736	scaffold_14	267802	268774	972	102	yes	365515	-
4737	scaffold_14	271938	273298	1360	163	yes	402638	-
4738	scaffold_14	292396	293025	629	48	yes	402644	-
4739	scaffold_14	296216	296224	8	3	no	NA	NA
4740	scaffold_14	296339	297664	1325	155	yes	365518	-
4741	scaffold_14	299344	300544	1200	145	yes	315308	-
4742	scaffold_14	301162	302542	1380	158	yes	424089	+
4743	scaffold_14	306620	307830	1210	154	yes	293002	-
4744	scaffold_14	315772	316820	1048	94	yes	315314	-
4745	scaffold_14	322042	323236	1194	106	yes	424094	-
4746	scaffold_14	325683	327040	1357	188	yes	315319	+
4747	scaffold_14	332522	333500	978	141	yes	39133	+
4748	scaffold_14	341233	342596	1363	134	yes	293014	+
4749	scaffold_14	349325	350357	1032	96	no	NA	NA
4750	scaffold_14	357726	358626	900	105	yes	315331,315332	-,+
4751	scaffold_14	358898	359903	1005	125	yes	315331,315332,315333	-,+,+
4752	scaffold_14	360335	361487	1152	106	yes	315333	+
4753	scaffold_14	364016	365317	1301	151	yes	390757	-
4754	scaffold_14	377464	378457	993	97	yes	39203	-
4755	scaffold_14	384977	386417	1440	143	yes	315338	+
4756	scaffold_14	388419	389516	1097	129	yes	315339	+
4757	scaffold_14	393921	393969	48	10	no	NA	NA
4758	scaffold_14	394132	395278	1146	118	yes	39234	-
4759	scaffold_14	398665	399845	1180	117	yes	402668	+
4760	scaffold_14	404379	405511	1132	96	yes	217162	-
4761	scaffold_14	408468	408946	478	38	yes	315346	-
4762	scaffold_14	411871	413229	1358	178	yes	39275	+
4763	scaffold_14	419123	420056	933	112	yes	424113	-
4764	scaffold_14	423357	425089	1732	167	yes	315352	+
4765	scaffold_14	429242	430600	1358	134	yes	243283,315357	+,+
4766	scaffold_14	438634	439641	1007	106	yes	315360	-
4767	scaffold_14	444232	445113	881	66	yes	315362	+
4768	scaffold_14	464756	465868	1112	136	no	NA	NA
4769	scaffold_14	480894	481993	1099	82	no	NA	NA
4770	scaffold_14	501706	501742	36	8	yes	424126	+
4771	scaffold_14	515622	516391	769	78	yes	315390	+
4772	scaffold_14	519376	519810	434	51	yes	293046	+
4773	scaffold_14	521646	521662	16	6	no	NA	NA
4774	scaffold_14	527115	527122	7	4	no	NA	NA
4775	scaffold_14	532235	533934	1699	119	yes	315393	+
4776	scaffold_14	540511	541270	759	95	no	NA	NA
4777	scaffold_14	541400	541835	435	62	yes	315396	-
4778	scaffold_14	542896	543670	774	91	yes	315398	-
4779	scaffold_14	543911	545000	1089	112	yes	315398,424132	-,+
4780	scaffold_14	546583	548077	1494	157	yes	293052	+
4781	scaffold_14	556332	557476	1144	159	yes	217225	-
4782	scaffold_14	567509	567554	45	10	yes	217235	-
4783	scaffold_14	567623	568612	989	120	yes	217235	-
4784	scaffold_14	598860	599816	956	126	yes	390793	-
4785	scaffold_14	622219	623238	1019	130	yes	315416	+
4786	scaffold_14	625498	626877	1379	140	yes	315418	+
4787	scaffold_14	629566	629574	8	3	yes	315419	-
4788	scaffold_14	637157	637426	269	38	yes	390798	-
4789	scaffold_14	637555	637567	12	4	yes	390798	-
4790	scaffold_14	638256	639815	1559	163	no	NA	NA
4791	scaffold_14	654863	655909	1046	113	yes	39621,315429	-,+
4792	scaffold_14	658141	659455	1314	117	yes	315432	-
4793	scaffold_14	661740	662836	1096	121	yes	39640	-
4794	scaffold_14	666100	667500	1400	147	yes	39646	+
4795	scaffold_14	681329	682542	1213	162	yes	315437	+
4796	scaffold_14	683952	685247	1295	122	yes	402728	+
4797	scaffold_14	689746	690768	1022	93	yes	424153	+
4798	scaffold_14	695484	696358	874	127	yes	315445	-
4799	scaffold_14	709882	710278	396	71	yes	390811	+
4800	scaffold_14	710352	710397	45	8	no	NA	NA
4801	scaffold_14	714610	715583	973	110	yes	315452	+
4802	scaffold_14	719602	720916	1314	134	yes	230789	-
4803	scaffold_14	721310	721315	5	4	yes	230789	-
4804	scaffold_14	721974	722409	435	38	no	NA	NA
4805	scaffold_14	722582	723663	1081	121	yes	424159	-
4806	scaffold_14	727305	728633	1328	134	yes	402736	-
4807	scaffold_14	730583	731545	962	118	yes	230792	-
4808	scaffold_14	734218	735977	1759	122	yes	424162	+
4809	scaffold_14	740957	741273	316	31	yes	243343	+
4810	scaffold_14	741368	741387	19	6	yes	243343	+
4811	scaffold_14	741560	741804	244	19	no	NA	NA
4812	scaffold_14	750721	752088	1367	180	yes	424166	-
4813	scaffold_14	754139	755151	1012	93	yes	39823	+
4814	scaffold_14	760317	761776	1459	166	yes	217072	+
4815	scaffold_14	765699	766416	717	70	yes	315473	-
4816	scaffold_14	772241	773331	1090	110	yes	217188	-
4817	scaffold_14	777281	778328	1047	129	yes	39948	+
4818	scaffold_14	780392	781347	955	90	yes	315477	-
4819	scaffold_14	781586	783097	1511	179	yes	315477,293099	-,+
4820	scaffold_14	789926	790768	842	100	yes	390826	-
4821	scaffold_14	797191	798207	1016	135	yes	40029	+
4822	scaffold_14	807078	807813	735	46	yes	390829	-
4823	scaffold_14	812678	814161	1483	131	yes	315493	-
4824	scaffold_14	814370	815595	1225	150	yes	315493,402758	-,+
4825	scaffold_14	817764	818915	1151	125	yes	315497	+
4826	scaffold_14	824503	825656	1153	152	yes	315505	-
4827	scaffold_14	839121	840139	1018	148	yes	315515	-
4828	scaffold_14	841222	842307	1085	110	yes	402765	+
4829	scaffold_14	850984	852009	1025	96	yes	315521	-
4830	scaffold_14	859513	860533	1020	82	no	NA	NA
4831	scaffold_14	867722	868629	907	98	yes	315524	-
4832	scaffold_14	869821	871143	1322	194	yes	315527	+
4833	scaffold_14	938191	938248	57	10	yes	293131	-
4834	scaffold_14	938425	939457	1032	71	yes	293131	-
4835	scaffold_14	942600	944122	1522	186	yes	230834	+
4836	scaffold_14	949369	950718	1349	104	yes	315544	+
4837	scaffold_14	952833	953908	1075	99	yes	40417,315550	+,-
4838	scaffold_14	954217	955380	1163	161	yes	40417,315550	+,-
4839	scaffold_14	970305	971307	1002	92	yes	390855	+
4840	scaffold_14	971655	972014	359	26	no	NA	NA
4841	scaffold_14	972249	972275	26	6	no	NA	NA
4842	scaffold_14	972828	972886	58	15	no	NA	NA
4843	scaffold_14	973273	974434	1161	121	yes	402794	+
4844	scaffold_14	986965	987769	804	90	yes	390857	+
4845	scaffold_14	990744	991460	716	84	yes	390858	+
4846	scaffold_14	994069	995127	1058	102	yes	230846	+
4847	scaffold_14	996339	997718	1379	151	yes	217011	+
4848	scaffold_14	1010597	1011474	877	70	yes	293144	-
4849	scaffold_14	1016576	1017276	700	71	yes	243403	+
4850	scaffold_14	1097254	1097521	267	22	yes	315947	-
4851	scaffold_14	1112263	1113000	737	54	yes	424229	+
4852	scaffold_14	1119640	1120864	1224	103	yes	369631	-
4853	scaffold_14	1123092	1124362	1270	160	yes	315956	+
4854	scaffold_14	1128770	1130179	1409	155	yes	424232	-
4855	scaffold_14	1135210	1136724	1514	211	yes	40902,315960	+,-
4856	scaffold_14	1136930	1138410	1480	182	yes	40902,315960	+,-
4857	scaffold_14	1149161	1150209	1048	139	yes	315965	-
4858	scaffold_14	1151100	1151956	856	70	yes	315969	+
4859	scaffold_14	1152629	1152649	20	4	no	NA	NA
4860	scaffold_14	1157852	1158160	308	30	yes	315973	-
4861	scaffold_14	1160782	1162036	1254	142	yes	315976	+
4862	scaffold_14	1168942	1170449	1507	114	yes	402840	+
4863	scaffold_14	1196959	1198146	1187	107	yes	293182	-
4864	scaffold_14	1234274	1235887	1613	153	yes	41130	-
4865	scaffold_14	1240326	1241532	1206	113	yes	217210	-
4866	scaffold_14	1247892	1249431	1539	165	yes	402855	+
4867	scaffold_14	1251295	1252810	1515	173	yes	293190	+
4868	scaffold_14	1256785	1257927	1142	130	yes	424249	+
4869	scaffold_14	1258831	1260444	1613	191	yes	424250	+
4870	scaffold_14	1274393	1275595	1202	97	yes	316005	-
4871	scaffold_14	1278467	1279889	1422	170	yes	216988	-
4872	scaffold_14	1281913	1282685	772	86	yes	243483	-
4873	scaffold_14	1282971	1283984	1013	134	yes	243483,316010	-,+
4874	scaffold_11	32290	33257	967	72	no	NA	NA
4875	scaffold_11	61844	62991	1147	135	yes	313636	+
4876	scaffold_11	73434	74631	1197	156	yes	313638	+
4877	scaffold_11	103021	104465	1444	158	yes	313650	+
4878	scaffold_11	109423	110692	1269	142	yes	313651	+
4879	scaffold_11	121577	123048	1471	163	yes	313654	+
4880	scaffold_11	127670	128940	1270	102	yes	313656	-
4881	scaffold_11	133286	134231	945	86	yes	368003	+
4882	scaffold_11	141255	142554	1299	154	yes	390063	-
4883	scaffold_11	144605	145562	957	121	yes	423387	+
4884	scaffold_11	154331	154587	256	25	no	NA	NA
4885	scaffold_11	159624	160984	1360	167	no	NA	NA
4886	scaffold_11	168923	170007	1084	119	yes	313669	-
4887	scaffold_11	173681	174457	776	70	yes	313670	-
4888	scaffold_11	179937	180685	748	83	yes	313673	+
4889	scaffold_11	185824	186666	842	93	yes	313676	-
4890	scaffold_11	187853	189004	1151	112	yes	313678	+
4891	scaffold_11	190902	192030	1128	98	yes	313681	+
4892	scaffold_11	195048	196376	1328	114	yes	416155	-
4893	scaffold_11	208046	209741	1695	167	yes	416157	+
4894	scaffold_11	216973	217870	897	94	yes	313694	+
4895	scaffold_11	220215	221186	971	108	yes	313699	-
4896	scaffold_11	241856	243115	1259	118	yes	313705	+
4897	scaffold_11	243232	243253	21	8	no	NA	NA
4898	scaffold_11	244099	245588	1489	145	yes	313710	-
4899	scaffold_11	246631	248015	1384	148	yes	292219	+
4900	scaffold_11	248107	248182	75	18	no	NA	NA
4901	scaffold_11	263376	264417	1041	115	yes	313714	+
4902	scaffold_11	265102	265910	808	135	yes	313719	+
4903	scaffold_11	270429	271713	1284	119	yes	292223	-
4904	scaffold_11	281668	281950	282	18	yes	423412	+
4905	scaffold_11	291081	292147	1066	131	yes	423413	+
4906	scaffold_11	307855	309149	1294	76	yes	390096	+
4907	scaffold_11	322935	323973	1038	118	yes	416179	+
4908	scaffold_11	333456	333473	17	7	no	NA	NA
4909	scaffold_11	334508	335548	1040	108	yes	313751	+
4910	scaffold_11	337634	338031	397	39	yes	313753	+
4911	scaffold_11	340090	340960	870	73	yes	313755	+
4912	scaffold_11	344082	345087	1005	99	yes	24537,416189	-,+
4913	scaffold_11	347859	348943	1084	104	yes	313762	+
4914	scaffold_11	351184	352402	1218	150	yes	313765	-
4915	scaffold_11	354962	355934	972	115	yes	313771,313774	-,+
4916	scaffold_11	356241	357428	1187	121	yes	313771,313774,390109	-,+,+
4917	scaffold_11	357706	358982	1276	136	yes	390109	+
4918	scaffold_11	367149	369044	1895	117	yes	423436	+
4919	scaffold_11	373858	374668	810	88	yes	313782	-
4920	scaffold_11	376518	376525	7	4	no	NA	NA
4921	scaffold_11	376648	377348	700	94	yes	313785	-
4922	scaffold_11	399690	400686	996	123	yes	24699,216521	+,+
4923	scaffold_11	415407	416637	1230	145	no	NA	NA
4924	scaffold_11	423761	425175	1414	167	yes	292256	+
4925	scaffold_11	427036	428049	1013	125	no	NA	NA
4926	scaffold_11	429466	430737	1271	127	yes	313798,313800	+,+
4927	scaffold_11	431109	432400	1291	209	yes	313800	+
4928	scaffold_11	438575	439865	1290	142	yes	313805	+
4929	scaffold_11	439967	439978	11	4	no	NA	NA
4930	scaffold_11	441620	443088	1468	157	yes	423449	-
4931	scaffold_11	453999	455866	1867	180	yes	390121	+
4932	scaffold_11	458815	459522	707	88	yes	313808	+
4933	scaffold_11	472354	473109	755	47	yes	313811	-
4934	scaffold_11	474713	475127	414	60	yes	313812	+
4935	scaffold_11	479514	480696	1182	144	yes	24866	-
4936	scaffold_11	482974	483579	605	58	yes	313814	-
4937	scaffold_11	492174	493228	1054	75	yes	416233	-
4938	scaffold_11	508784	510477	1693	149	yes	292275	+
4939	scaffold_11	515141	515151	10	4	yes	390133	+
4940	scaffold_11	515296	515497	201	10	yes	390133	+
4941	scaffold_11	522614	523231	617	54	yes	416238	+
4942	scaffold_11	549625	549652	27	8	no	NA	NA
4943	scaffold_11	549843	549871	28	10	yes	368071	-
4944	scaffold_11	549994	550091	97	16	yes	368071	-
4945	scaffold_11	550168	550564	396	60	yes	368071	-
4946	scaffold_11	558346	558977	631	78	no	NA	NA
4947	scaffold_11	567430	568154	724	66	yes	313838	-
4948	scaffold_11	582872	583814	942	94	yes	292288	-
4949	scaffold_11	584572	584974	402	37	no	NA	NA
4950	scaffold_11	589107	589174	67	12	no	NA	NA
4951	scaffold_11	589355	590412	1057	115	yes	416252	-
4952	scaffold_11	590764	590785	21	8	no	NA	NA
4953	scaffold_11	595171	596401	1230	144	no	NA	NA
4954	scaffold_11	601820	602394	574	56	yes	423476	-
4955	scaffold_11	616853	618511	1658	182	yes	313863	+
4956	scaffold_11	632343	633672	1329	145	yes	416263	+
4957	scaffold_11	639079	640267	1188	150	no	NA	NA
4958	scaffold_11	647816	649784	1968	147	yes	313880	+
4959	scaffold_11	649915	649941	26	4	no	NA	NA
4960	scaffold_11	659061	660933	1872	171	no	NA	NA
4961	scaffold_11	668707	669764	1057	136	yes	368082	-
4962	scaffold_11	675061	676680	1619	209	yes	292307	-
4963	scaffold_11	682547	683905	1358	147	yes	365424	-
4964	scaffold_11	687904	688732	828	103	yes	313895	-
4965	scaffold_11	689836	691154	1318	150	yes	313897	+
4966	scaffold_11	694058	694888	830	69	yes	423494	+
4967	scaffold_11	696328	697391	1063	150	yes	416275	+
4968	scaffold_11	700607	702219	1612	196	yes	313903	+
4969	scaffold_11	706136	707679	1543	184	yes	423496	+
4970	scaffold_11	737476	738959	1483	146	no	NA	NA
4971	scaffold_11	754696	754702	6	4	yes	292317	+
4972	scaffold_11	763805	764100	295	27	yes	313938	+
4973	scaffold_11	764275	764288	13	5	no	NA	NA
4974	scaffold_11	767923	768729	806	73	yes	423501	-
4975	scaffold_11	769173	769238	65	20	yes	423501	-
4976	scaffold_11	770293	771007	714	115	yes	423502	+
4977	scaffold_11	777104	777886	782	90	no	NA	NA
4978	scaffold_11	785834	785988	154	11	yes	423505	+
4979	scaffold_11	790292	791115	823	82	yes	423507	+
4980	scaffold_11	798702	798989	287	44	no	NA	NA
4981	scaffold_11	809659	809665	6	4	no	NA	NA
4982	scaffold_11	814817	815144	327	42	yes	313949	+
4983	scaffold_11	815425	815459	34	8	no	NA	NA
4984	scaffold_11	821176	821562	386	41	yes	423511	+
4985	scaffold_11	829448	830087	639	52	yes	313953	-
4986	scaffold_11	835358	835726	368	23	no	NA	NA
4987	scaffold_11	836130	836890	760	68	yes	313974	-
4988	scaffold_11	855946	856150	204	20	yes	313982	-
4989	scaffold_11	856249	856486	237	21	yes	313982	-
4990	scaffold_11	862144	862843	699	59	yes	25493	-
4991	scaffold_11	894052	894059	7	4	no	NA	NA
4992	scaffold_11	894301	895408	1107	117	yes	313990,313996	-,+
4993	scaffold_11	895606	897157	1551	158	yes	313990,313996	-,+
4994	scaffold_11	897439	897526	87	12	no	NA	NA
4995	scaffold_11	898118	899539	1421	156	yes	314001,423526	+,-
4996	scaffold_11	899893	900964	1071	97	yes	314001,423526	+,-
4997	scaffold_11	905398	906756	1358	125	yes	416324	-
4998	scaffold_11	910936	912437	1501	120	no	NA	NA
4999	scaffold_11	918247	919129	882	104	yes	314007	-
5000	scaffold_11	920010	920845	835	72	yes	314008	+
5001	scaffold_11	922372	922384	12	4	yes	423532	+
5002	scaffold_11	933622	934388	766	120	yes	423535	+
5003	scaffold_11	948967	950299	1332	123	no	NA	NA
5004	scaffold_11	954356	955750	1394	157	yes	385230	-
5005	scaffold_11	958449	959677	1228	117	yes	390205	+
5006	scaffold_11	972733	973584	851	47	yes	423541	+
5007	scaffold_11	973767	973786	19	3	yes	423541	+
5008	scaffold_11	984498	985868	1370	128	yes	416343	+
5009	scaffold_11	1001308	1002516	1208	166	yes	314044	+
5010	scaffold_11	1008483	1009867	1384	155	yes	423546	-
5011	scaffold_11	1016335	1017408	1073	158	no	NA	NA
5012	scaffold_11	1018761	1019029	268	17	yes	314050	-
5013	scaffold_11	1023430	1023831	401	43	yes	25922	-
5014	scaffold_11	1037147	1037973	826	125	yes	416356	-
5015	scaffold_11	1039178	1039977	799	96	yes	314071	-
5016	scaffold_11	1041815	1043317	1502	97	yes	416358	+
5017	scaffold_11	1047127	1047147	20	4	yes	314075	-
5018	scaffold_11	1052325	1053240	915	85	yes	416360	-
5019	scaffold_11	1064358	1066112	1754	193	yes	314080	-
5020	scaffold_11	1069054	1070085	1031	117	yes	314082	+
5021	scaffold_11	1076382	1077236	854	87	yes	314089	+
5022	scaffold_11	1077759	1079170	1411	160	yes	314089	+
5023	scaffold_11	1083819	1085176	1357	141	yes	314101	+
5024	scaffold_11	1090617	1091603	986	129	yes	314103	-
5025	scaffold_11	1093027	1094206	1179	143	yes	314106	+
5026	scaffold_11	1096015	1097273	1258	124	yes	314109	+
5027	scaffold_11	1101696	1103325	1629	139	yes	230207	-
5028	scaffold_11	1106032	1106632	600	78	yes	242766	-
5029	scaffold_11	1109540	1110747	1207	101	yes	314114	+
5030	scaffold_11	1115874	1117091	1217	126	yes	26148	-
5031	scaffold_11	1122268	1123495	1227	110	yes	26167	-
5032	scaffold_11	1129968	1130811	843	92	yes	314121	+
5033	scaffold_11	1147610	1148576	966	118	yes	216503	+
5034	scaffold_11	1152993	1153802	809	85	yes	292396	+
5035	scaffold_11	1158214	1159516	1302	85	no	NA	NA
5036	scaffold_11	1175387	1176189	802	92	yes	314126	+
5037	scaffold_11	1180577	1181505	928	109	yes	314129	+
5038	scaffold_11	1191897	1191918	21	6	no	NA	NA
5039	scaffold_11	1192144	1192626	482	54	yes	423579	-
5040	scaffold_11	1218542	1219318	776	54	yes	390245	+
5041	scaffold_11	1233728	1234322	594	62	yes	314143	-
5042	scaffold_11	1237977	1238815	838	75	yes	26300	+
5043	scaffold_11	1278644	1279744	1100	99	no	NA	NA
5044	scaffold_11	1279985	1280150	165	16	yes	314156	+
5045	scaffold_11	1280478	1281748	1270	145	yes	314156,314159	+,+
5046	scaffold_11	1281930	1282745	815	90	yes	314159	+
5047	scaffold_11	1284192	1285352	1160	104	yes	314164	+
5048	scaffold_11	1294833	1295486	653	68	yes	314166	+
5049	scaffold_11	1295746	1295754	8	3	no	NA	NA
5050	scaffold_11	1304884	1306020	1136	95	yes	416421	-
5051	scaffold_30	7763	8668	905	82	yes	296319	-
5052	scaffold_30	9228	9598	370	48	no	NA	NA
5053	scaffold_30	14620	15411	791	83	yes	410920	+
5054	scaffold_30	38483	39367	884	89	yes	393519	+
5055	scaffold_30	40963	42331	1368	101	yes	322623	+
5056	scaffold_30	46297	46320	23	4	no	NA	NA
5057	scaffold_30	48245	49211	966	107	yes	98627	+
5058	scaffold_30	50573	51576	1003	100	yes	322626	+
5059	scaffold_30	57228	58109	881	98	yes	322628	+
5060	scaffold_30	61977	63584	1607	138	yes	393523	+
5061	scaffold_30	64729	65817	1088	102	yes	426893	+
5062	scaffold_30	67911	68975	1064	115	yes	426894	+
5063	scaffold_30	71353	71362	9	4	no	NA	NA
5064	scaffold_30	74325	75397	1072	165	no	NA	NA
5065	scaffold_30	87200	87436	236	29	yes	374328	+
5066	scaffold_30	90031	90726	695	83	yes	296332	-
5067	scaffold_30	99964	101099	1135	96	yes	98697	+
5068	scaffold_30	106424	107620	1196	160	yes	322652	-
5069	scaffold_30	108217	109417	1200	119	no	NA	NA
5070	scaffold_30	112039	113328	1289	110	yes	322658	-
5071	scaffold_30	117513	118680	1167	113	yes	98737	+
5072	scaffold_30	121140	122506	1366	123	no	NA	NA
5073	scaffold_30	122627	122634	7	4	no	NA	NA
5074	scaffold_30	130030	131102	1072	68	yes	322669	+
5075	scaffold_30	134955	135810	855	61	yes	322671	-
5076	scaffold_30	140945	142259	1314	151	yes	296343	-
5077	scaffold_30	145226	145252	26	6	no	NA	NA
5078	scaffold_30	145399	146856	1457	143	no	NA	NA
5079	scaffold_30	153771	154552	781	101	no	NA	NA
5080	scaffold_30	156377	156460	83	30	no	NA	NA
5081	scaffold_30	166602	166631	29	7	yes	322677	-
5082	scaffold_30	166836	166883	47	7	yes	322677	-
5083	scaffold_30	193321	194861	1540	151	yes	98901	+
5084	scaffold_30	200837	201388	551	61	no	NA	NA
5085	scaffold_30	204555	205762	1207	92	yes	98923	-
5086	scaffold_30	208259	209228	969	115	yes	322682	-
5087	scaffold_30	211713	212416	703	47	yes	410964	+
5088	scaffold_30	219143	220098	955	84	yes	296353	+
5089	scaffold_30	234885	235969	1084	91	yes	322690	-
5090	scaffold_30	246794	247983	1189	171	yes	220057	-
5091	scaffold_30	263052	264137	1085	156	yes	322699	-
5092	scaffold_30	264308	265531	1223	133	yes	322699,296362	-,+
5093	scaffold_30	277908	279373	1465	161	yes	410979	+
5094	scaffold_30	285496	286971	1475	172	yes	410980	-
5095	scaffold_30	289120	289793	673	68	yes	322712	+
5096	scaffold_30	291380	292768	1388	139	yes	426926	+
5097	scaffold_30	292945	292953	8	4	no	NA	NA
5098	scaffold_30	299916	301075	1159	137	yes	322718	-
5099	scaffold_30	315146	316272	1126	132	yes	322726,426930	+,-
5100	scaffold_30	316700	317650	950	102	yes	322726,426930	+,-
5101	scaffold_30	320931	321153	222	22	no	NA	NA
5102	scaffold_30	321400	321447	47	4	no	NA	NA
5103	scaffold_30	321591	322772	1181	115	no	NA	NA
5104	scaffold_30	336290	337002	712	62	yes	322743	+
5105	scaffold_30	337430	338849	1419	126	yes	410991	-
5106	scaffold_30	340812	342110	1298	129	yes	322746	-
5107	scaffold_30	344269	345109	840	107	yes	322748	+
5108	scaffold_30	348781	350498	1717	181	yes	322749	-
5109	scaffold_30	351155	352700	1545	189	yes	220187	+
5110	scaffold_30	360791	361755	964	74	yes	322753	+
5111	scaffold_30	376963	378776	1813	197	yes	393574	-
5112	scaffold_30	384563	386166	1603	210	yes	393575	-
5113	scaffold_30	393017	394518	1501	126	yes	393577	-
5114	scaffold_30	397658	397739	81	15	no	NA	NA
5115	scaffold_30	400604	401743	1139	126	yes	322764	+
5116	scaffold_30	405161	406459	1298	161	no	NA	NA
5117	scaffold_30	437639	438305	666	69	yes	411009	-
5118	scaffold_30	439656	440086	430	70	yes	322776	+
5119	scaffold_30	453522	454903	1381	99	yes	322779	+
5120	scaffold_30	470149	471699	1550	200	yes	296405	-
5121	scaffold_30	474479	475373	894	81	yes	322789	-
5122	scaffold_30	477615	478863	1248	116	no	NA	NA
5123	scaffold_30	478954	479193	239	37	no	NA	NA
5124	scaffold_30	479829	480685	856	120	no	NA	NA
5125	scaffold_30	486585	487874	1289	147	yes	322794	+
5126	scaffold_30	491414	492734	1320	178	yes	322797	-
5127	scaffold_30	508436	508926	490	33	yes	322802	+
5128	scaffold_30	515635	516955	1320	130	yes	426963	-
5129	scaffold_30	529617	529958	341	29	yes	220056	-
5130	scaffold_30	536712	536901	189	14	yes	322812	+
5131	scaffold_30	538772	539383	611	51	yes	322813	+
5132	scaffold_30	555640	556567	927	107	yes	393605	-
5133	scaffold_30	569019	569723	704	72	yes	322822	+
5134	scaffold_30	594321	595081	760	98	yes	374437	-
5135	scaffold_30	595693	597727	2034	234	yes	411050	-
5136	scaffold_30	597833	597842	9	4	yes	411050	-
5137	scaffold_30	599467	599481	14	4	no	NA	NA
5138	scaffold_30	599637	600675	1038	153	yes	411051	-
5139	scaffold_30	607277	608617	1340	172	no	NA	NA
5140	scaffold_30	614208	615914	1706	196	yes	426981	+
5141	scaffold_30	624940	625633	693	80	yes	411057	-
5142	scaffold_30	635675	636083	408	37	yes	411058	+
5143	scaffold_30	657544	659029	1485	138	yes	411064	+
5144	scaffold_30	664572	665965	1393	144	yes	220160	-
5145	scaffold_30	666703	667805	1102	137	yes	411066	+
5146	scaffold_30	669649	669686	37	10	no	NA	NA
5147	scaffold_30	669821	671137	1316	131	yes	220063,393615	-,+
5148	scaffold_30	675692	677027	1335	105	yes	220091,322870	-,+
5149	scaffold_30	679642	680988	1346	127	yes	411070	+
5150	scaffold_30	686430	687420	990	117	yes	322874	+
5151	scaffold_30	689961	691347	1386	152	yes	246017	+
5152	scaffold_30	702896	703161	265	26	yes	393620	+
5153	scaffold_30	713220	714260	1040	121	yes	411075	+
5154	scaffold_30	740705	741353	648	61	yes	246020	-
5155	scaffold_30	744829	744844	15	6	yes	322896	-
5156	scaffold_30	749635	749730	95	14	no	NA	NA
5157	scaffold_30	752443	753224	781	108	no	NA	NA
5158	scaffold_30	758857	759796	939	103	yes	411086	-
5159	scaffold_30	762460	763253	793	46	yes	427005	-
5160	scaffold_30	765997	767362	1365	174	yes	233610	+
5161	scaffold_30	775032	775206	174	24	no	NA	NA
5162	scaffold_30	775419	776062	643	45	yes	322904	-
5163	scaffold_30	785361	786458	1097	124	yes	322906	+
5164	scaffold_30	786573	786597	24	6	no	NA	NA
5165	scaffold_30	822455	823697	1242	133	no	NA	NA
5166	scaffold_30	829717	830064	347	25	yes	427016	-
5167	scaffold_30	833821	835085	1264	179	yes	411102	+
5168	scaffold_31	17655	18768	1113	166	yes	393648	-
5169	scaffold_31	23298	24575	1277	129	yes	322938	+
5170	scaffold_31	28742	29908	1166	141	yes	322941	-
5171	scaffold_31	30200	31098	898	118	yes	322941,322943	-,-
5172	scaffold_31	45463	46830	1367	154	yes	414361	-
5173	scaffold_31	47355	48375	1020	121	yes	322948	-
5174	scaffold_31	52354	53686	1332	173	yes	322950	+
5175	scaffold_31	55821	56621	800	75	yes	322953	+
5176	scaffold_31	61066	62218	1152	155	yes	322956,393658	+,-
5177	scaffold_31	62413	63392	979	124	yes	322956,393658	+,-
5178	scaffold_31	66961	68889	1928	203	yes	322958	+
5179	scaffold_31	71260	73045	1785	214	yes	296492	+
5180	scaffold_31	75851	75862	11	4	yes	322965	+
5181	scaffold_31	76134	77159	1025	122	yes	322965	+
5182	scaffold_31	77297	77304	7	3	no	NA	NA
5183	scaffold_31	79914	81092	1178	94	yes	322967	-
5184	scaffold_31	90142	91297	1155	128	yes	246074,322970	-,+
5185	scaffold_31	91633	92609	976	94	yes	246074,322970	-,+
5186	scaffold_31	100701	101627	926	61	yes	322975	-
5187	scaffold_31	103957	104922	965	140	yes	322978	-
5188	scaffold_31	105789	107029	1240	152	yes	427041,427042	-,+
5189	scaffold_31	107223	108579	1356	127	yes	427041,427042	-,+
5190	scaffold_31	116432	117161	729	52	yes	427043	+
5191	scaffold_31	117347	117355	8	4	no	NA	NA
5192	scaffold_31	122300	123638	1338	139	no	NA	NA
5193	scaffold_31	124440	124449	9	4	no	NA	NA
5194	scaffold_31	124639	125875	1236	119	yes	414382	+
5195	scaffold_31	135524	135552	28	10	yes	414386	-
5196	scaffold_31	138553	138569	16	4	no	NA	NA
5197	scaffold_31	138758	139943	1185	90	yes	296505	-
5198	scaffold_31	147566	149494	1928	202	no	NA	NA
5199	scaffold_31	151252	153014	1762	185	yes	393673	+
5200	scaffold_31	158099	159184	1085	97	yes	322989	+
5201	scaffold_31	163203	164629	1426	121	yes	322990	+
5202	scaffold_31	167463	168350	887	108	no	NA	NA
5203	scaffold_31	171849	173118	1269	128	yes	393676	+
5204	scaffold_31	173484	173654	170	17	no	NA	NA
5205	scaffold_31	180565	181039	474	29	no	NA	NA
5206	scaffold_31	184437	185681	1244	98	yes	323001	+
5207	scaffold_31	185934	185956	22	6	no	NA	NA
5208	scaffold_31	189487	189993	506	50	yes	393679	+
5209	scaffold_31	190293	190384	91	10	no	NA	NA
5210	scaffold_31	195371	196467	1096	76	yes	323004	+
5211	scaffold_31	200393	201789	1396	137	yes	323008	+
5212	scaffold_31	204319	205687	1368	202	yes	374557	+
5213	scaffold_31	229574	230436	862	80	yes	323015	+
5214	scaffold_31	253629	253635	6	4	no	NA	NA
5215	scaffold_31	255388	256801	1413	165	yes	323021	-
5216	scaffold_31	259629	261025	1396	172	yes	101238	+
5217	scaffold_31	271110	271840	730	84	yes	414410	-
5218	scaffold_31	272471	272502	31	6	no	NA	NA
5219	scaffold_31	274023	274710	687	41	yes	393695	+
5220	scaffold_31	280269	281826	1557	220	yes	427068	+
5221	scaffold_31	290222	290958	736	55	no	NA	NA
5222	scaffold_31	325745	326307	562	46	yes	323039	-
5223	scaffold_31	327949	329623	1674	206	yes	101348	+
5224	scaffold_31	337742	337749	7	4	no	NA	NA
5225	scaffold_31	337938	338278	340	39	yes	414423	-
5226	scaffold_31	341315	342428	1113	124	no	NA	NA
5227	scaffold_31	344035	344993	958	90	yes	323047	-
5228	scaffold_31	350278	350844	566	61	yes	323051	-
5229	scaffold_31	354745	355553	808	132	yes	323053	+
5230	scaffold_31	374977	376559	1582	133	yes	101436	+
5231	scaffold_31	403259	404340	1081	144	yes	427084	-
5232	scaffold_31	422713	422722	9	4	no	NA	NA
5233	scaffold_31	422800	422888	88	4	no	NA	NA
5234	scaffold_31	423111	423589	478	36	yes	393714	-
5235	scaffold_31	428127	428366	239	33	yes	323065	+
5236	scaffold_31	436576	438063	1487	163	yes	323067	-
5237	scaffold_31	439739	440477	738	84	yes	323068	-
5238	scaffold_31	442975	443555	580	56	yes	296567	-
5239	scaffold_31	448018	449262	1244	126	yes	233687	-
5240	scaffold_31	450988	452061	1073	130	yes	393720	-
5241	scaffold_31	463539	465194	1655	160	no	NA	NA
5242	scaffold_31	468137	469778	1641	212	yes	393723	+
5243	scaffold_31	474733	474749	16	4	yes	323084	+
5244	scaffold_31	475208	476518	1310	148	yes	323084	+
5245	scaffold_31	481350	482825	1475	194	yes	323088,365950	-,+
5246	scaffold_31	483506	485060	1554	136	yes	323091	+
5247	scaffold_31	485309	485979	670	56	yes	414465	-
5248	scaffold_31	488763	490095	1332	119	yes	101708	-
5249	scaffold_31	498101	499578	1477	184	yes	233699,393732	+,-
5250	scaffold_31	500040	501134	1094	135	yes	233699,393732,296585	+,-,+
5251	scaffold_31	501439	502657	1218	139	yes	296585,296586	+,+
5252	scaffold_31	508213	509385	1172	173	yes	323108	+
5253	scaffold_31	513910	515267	1357	121	yes	365955	-
5254	scaffold_31	517995	519008	1013	122	no	NA	NA
5255	scaffold_31	520063	520868	805	104	yes	101849	-
5256	scaffold_31	522770	523227	457	55	yes	393739	-
5257	scaffold_31	523852	524833	981	107	yes	296591	+
5258	scaffold_31	532137	533284	1147	127	yes	323118	-
5259	scaffold_31	537539	538796	1257	147	yes	323122	+
5260	scaffold_31	550104	551232	1128	123	no	NA	NA
5261	scaffold_31	554544	554564	20	4	no	NA	NA
5262	scaffold_31	554680	555678	998	94	yes	323133	-
5263	scaffold_31	557903	559075	1172	166	yes	393746	+
5264	scaffold_31	568087	569607	1520	162	yes	393747	-
5265	scaffold_31	570870	571761	891	88	yes	102042	+
5266	scaffold_31	573532	574767	1235	151	no	NA	NA
5267	scaffold_31	581919	581976	57	16	yes	427123	-
5268	scaffold_31	586532	587106	574	46	yes	427124	+
5269	scaffold_31	591273	592324	1051	110	yes	296606	+
5270	scaffold_31	609225	610687	1462	191	yes	102129	+
5271	scaffold_31	616212	617195	983	122	yes	323149	-
5272	scaffold_31	625496	625550	54	14	no	NA	NA
5273	scaffold_31	625806	626059	253	40	no	NA	NA
5274	scaffold_31	627558	628517	959	113	yes	323152	-
5275	scaffold_31	630925	630960	35	10	no	NA	NA
5276	scaffold_31	631120	631984	864	83	yes	323154	-
5277	scaffold_31	681098	681130	32	10	yes	323160	+
5278	scaffold_31	684388	686142	1754	126	yes	414502	-
5279	scaffold_31	691457	692551	1094	68	yes	323165	-
5280	scaffold_31	732576	733836	1260	193	yes	323171	-
5281	scaffold_31	740394	741435	1041	107	yes	323173	-
5282	scaffold_31	747656	747843	187	16	yes	427144	-
5283	scaffold_31	769057	769415	358	50	yes	427146	+
5284	scaffold_31	777332	778422	1090	144	no	NA	NA
5285	scaffold_31	791914	791984	70	14	yes	246166	+
5286	scaffold_31	810690	810747	57	14	yes	246168	-
5287	scaffold_31	816423	817505	1082	165	no	NA	NA
5288	scaffold_31	834834	835799	965	75	yes	323207	-
5289	scaffold_24	3307	6692	3385	333	no	NA	NA
5290	scaffold_24	13654	14882	1228	55	yes	419437	+
5291	scaffold_24	24609	26259	1650	149	yes	320516	-
5292	scaffold_24	38898	39912	1014	84	no	NA	NA
5293	scaffold_24	55461	57150	1689	174	yes	79805	-
5294	scaffold_24	60572	61571	999	108	yes	392608	-
5295	scaffold_24	63320	64281	961	109	yes	320531	+
5296	scaffold_24	67922	69487	1565	229	yes	425990	-
5297	scaffold_24	78096	79493	1397	149	yes	320534	-
5298	scaffold_24	82740	83523	783	81	yes	320540	-
5299	scaffold_24	89972	91112	1140	102	yes	320544	+
5300	scaffold_24	95119	96487	1368	191	yes	232665	-
5301	scaffold_24	96912	98454	1542	180	yes	419462	-
5302	scaffold_24	104761	105929	1168	152	yes	320555	-
5303	scaffold_24	109361	110690	1329	117	yes	320557	+
5304	scaffold_24	110816	110838	22	5	no	NA	NA
5305	scaffold_24	113512	113527	15	4	no	NA	NA
5306	scaffold_24	113952	114884	932	100	yes	392621	-
5307	scaffold_24	128615	130114	1499	157	yes	219228	-
5308	scaffold_24	136642	138019	1377	109	yes	320567	-
5309	scaffold_24	139569	139586	17	8	no	NA	NA
5310	scaffold_24	159772	160575	803	117	no	NA	NA
5311	scaffold_24	167863	169523	1660	180	yes	295254	-
5312	scaffold_24	172844	172895	51	8	no	NA	NA
5313	scaffold_24	173393	173424	31	6	yes	392631,392632	-,+
5314	scaffold_24	173745	175025	1280	130	yes	392631,392632	-,+
5315	scaffold_24	176599	177639	1040	120	yes	320584,320586	-,+
5316	scaffold_24	178044	179336	1292	136	yes	320584,320586	-,+
5317	scaffold_24	184365	185509	1144	134	yes	320591	-
5318	scaffold_24	194415	195769	1354	117	yes	320598	+
5319	scaffold_24	204299	205388	1089	97	yes	320599	+
5320	scaffold_24	226212	227299	1087	109	yes	426022	-
5321	scaffold_24	235889	236543	654	62	yes	392644	-
5322	scaffold_24	237983	240063	2080	226	no	NA	NA
5323	scaffold_24	262605	263796	1191	164	yes	320618	-
5324	scaffold_24	276768	277909	1141	166	yes	392649	+
5325	scaffold_24	278574	278594	20	6	no	NA	NA
5326	scaffold_24	280919	282236	1317	109	yes	320627	-
5327	scaffold_24	398693	399694	1001	114	no	NA	NA
5328	scaffold_24	411021	411553	532	69	no	NA	NA
5329	scaffold_24	411807	412389	582	60	no	NA	NA
5330	scaffold_24	412535	412613	78	8	no	NA	NA
5331	scaffold_24	428520	428626	106	18	yes	232705	-
5332	scaffold_24	428721	429148	427	57	no	NA	NA
5333	scaffold_24	440639	441750	1111	112	yes	295313	-
5334	scaffold_24	441865	441938	73	12	yes	295313	-
5335	scaffold_24	442566	442578	12	4	no	NA	NA
5336	scaffold_24	451557	452155	598	68	yes	392676	-
5337	scaffold_24	460497	461076	579	77	yes	320736	+
5338	scaffold_24	463421	464624	1203	115	yes	320738	+
5339	scaffold_24	475068	476438	1370	116	yes	320742	+
5340	scaffold_24	480694	481601	907	52	yes	295322	-
5341	scaffold_24	488649	488656	7	4	no	NA	NA
5342	scaffold_24	492605	493364	759	84	no	NA	NA
5343	scaffold_24	493693	493971	278	46	no	NA	NA
5344	scaffold_24	495255	496334	1079	120	yes	320747	+
5345	scaffold_24	498864	499064	200	18	no	NA	NA
5346	scaffold_24	499377	500914	1537	161	yes	392684	-
5347	scaffold_24	501680	502683	1003	127	yes	320762	+
5348	scaffold_24	511967	513363	1396	110	yes	320764	+
5349	scaffold_24	525248	526100	852	112	yes	320770	-
5350	scaffold_24	531274	533186	1912	198	yes	320773	+
5351	scaffold_24	538188	539412	1224	101	yes	80915	+
5352	scaffold_24	542856	544087	1231	180	yes	320777	+
5353	scaffold_24	544179	544205	26	6	no	NA	NA
5354	scaffold_24	549718	551151	1433	160	yes	419571	-
5355	scaffold_24	557374	558664	1290	127	yes	295335	-
5356	scaffold_24	563796	563803	7	4	no	NA	NA
5357	scaffold_24	563976	565030	1054	110	yes	320787	-
5358	scaffold_24	568276	569479	1203	143	yes	419576	+
5359	scaffold_24	569622	569634	12	4	no	NA	NA
5360	scaffold_24	572362	573615	1253	138	yes	392698	-
5361	scaffold_24	575735	576772	1037	118	yes	320793	+
5362	scaffold_24	582953	584437	1484	149	yes	426084	-
5363	scaffold_24	594311	595449	1138	140	yes	320800	-
5364	scaffold_24	600272	601374	1102	76	yes	320803	+
5365	scaffold_24	608626	610312	1686	182	yes	81091	-
5366	scaffold_24	612044	613069	1025	109	yes	320808	-
5367	scaffold_24	646124	646882	758	85	yes	320810	+
5368	scaffold_24	719036	719129	93	10	no	NA	NA
5369	scaffold_24	719261	720044	783	101	no	NA	NA
5370	scaffold_24	723641	725227	1586	165	yes	320818	+
5371	scaffold_24	735175	736606	1431	138	no	NA	NA
5372	scaffold_24	743431	744979	1548	82	yes	81307	-
5373	scaffold_24	746499	747044	545	63	no	NA	NA
5374	scaffold_24	747768	749190	1422	188	yes	320841	+
5375	scaffold_24	750342	750358	16	4	no	NA	NA
5376	scaffold_24	756758	757753	995	102	yes	320843	-
5377	scaffold_24	773167	773848	681	73	yes	320848	-
5378	scaffold_24	779711	779718	7	4	yes	320855	-
5379	scaffold_24	785440	786309	869	111	no	NA	NA
5380	scaffold_24	788133	789735	1602	171	yes	320857	-
5381	scaffold_24	795947	796015	68	12	no	NA	NA
5382	scaffold_24	796179	796577	398	40	no	NA	NA
5383	scaffold_24	801351	802100	749	85	yes	320861	+
5384	scaffold_24	812680	813281	601	64	yes	392724	+
5385	scaffold_24	813358	813855	497	55	yes	392724	+
5386	scaffold_24	813932	814056	124	12	no	NA	NA
5387	scaffold_24	818312	820425	2113	184	yes	232746	+
5388	scaffold_24	823732	825723	1991	272	yes	320869	+
5389	scaffold_24	835346	837091	1745	194	yes	320872	-
5390	scaffold_24	847919	848921	1002	70	no	NA	NA
5391	scaffold_24	849537	849949	412	20	no	NA	NA
5392	scaffold_24	879836	880289	453	70	no	NA	NA
5393	scaffold_24	882391	883723	1332	105	yes	320903	+
5394	scaffold_24	888238	889514	1276	157	yes	320909	+
5395	scaffold_24	898722	900490	1768	159	yes	419654	+
5396	scaffold_24	905894	907392	1498	165	yes	219245	+
5397	scaffold_24	929451	930357	906	107	yes	219258	-
5398	scaffold_24	932152	932993	841	81	yes	426127	+
5399	scaffold_24	938677	940027	1350	123	no	NA	NA
5400	scaffold_24	942140	942177	37	6	no	NA	NA
5401	scaffold_24	942353	943663	1310	132	yes	419664	-
5402	scaffold_24	947538	948626	1088	123	yes	320929	+
5403	scaffold_24	951132	952129	997	98	no	NA	NA
5404	scaffold_24	957662	957747	85	20	yes	320936	+
5405	scaffold_24	957866	957943	77	20	yes	320936	+
5406	scaffold_24	986361	987723	1362	114	yes	419674	-
5407	scaffold_24	993946	995399	1453	175	yes	245266	+
5408	scaffold_24	1015038	1016520	1482	93	yes	82011	+
5409	scaffold_24	1020827	1021732	905	78	yes	320955	+
5410	scaffold_24	1032218	1032494	276	42	yes	320958	+
5411	scaffold_24	1032880	1033009	129	22	no	NA	NA
5412	scaffold_24	1035588	1036761	1173	124	yes	202805	+
5413	scaffold_24	1037974	1039327	1353	126	yes	295411	+
5414	scaffold_24	1053908	1054372	464	51	yes	320969	+
5415	scaffold_24	1058731	1059561	830	110	yes	320977	+
5416	scaffold_24	1071825	1072558	733	25	yes	320978	-
5417	scaffold_32	7846	7860	14	6	no	NA	NA
5418	scaffold_32	20351	20857	506	45	yes	296674	-
5419	scaffold_32	26332	28094	1762	151	yes	323229	+
5420	scaffold_32	32867	34102	1235	116	yes	323232	+
5421	scaffold_32	65647	66865	1218	104	no	NA	NA
5422	scaffold_32	70168	70296	128	8	no	NA	NA
5423	scaffold_32	70626	70665	39	3	no	NA	NA
5424	scaffold_32	71180	71189	9	4	yes	403609	-
5425	scaffold_32	76258	77247	989	142	yes	102624	-
5426	scaffold_32	77399	77564	165	19	yes	102624	-
5427	scaffold_32	77826	77860	34	12	no	NA	NA
5428	scaffold_32	87492	87515	23	6	yes	296683	-
5429	scaffold_32	87915	87922	7	4	no	NA	NA
5430	scaffold_32	88345	88374	29	10	no	NA	NA
5431	scaffold_32	97831	99310	1479	117	yes	403614	-
5432	scaffold_32	100869	100875	6	4	no	NA	NA
5433	scaffold_32	106754	108900	2146	188	yes	403615	-
5434	scaffold_32	113659	115063	1404	164	yes	323271	-
5435	scaffold_32	118845	120149	1304	158	yes	427177	-
5436	scaffold_32	124628	124686	58	6	no	NA	NA
5437	scaffold_32	124810	125449	639	60	yes	233781	-
5438	scaffold_32	130413	131652	1239	128	yes	296692	-
5439	scaffold_32	134205	134262	57	7	no	NA	NA
5440	scaffold_32	134582	134619	37	4	no	NA	NA
5441	scaffold_32	134768	134778	10	4	no	NA	NA
5442	scaffold_32	138947	139782	835	120	yes	102806	+
5443	scaffold_32	139935	140084	149	10	no	NA	NA
5444	scaffold_32	154472	155955	1483	205	yes	427182	-
5445	scaffold_32	178877	180098	1221	160	yes	220431	+
5446	scaffold_32	183703	184902	1199	175	yes	323297	+
5447	scaffold_32	191731	193206	1475	186	yes	323302	+
5448	scaffold_32	202005	203488	1483	168	yes	427190	-
5449	scaffold_32	206691	207870	1179	127	yes	427191	+
5450	scaffold_32	209825	210086	261	28	yes	323308	-
5451	scaffold_32	221467	221492	25	8	no	NA	NA
5452	scaffold_32	221690	222801	1111	146	yes	393826	-
5453	scaffold_32	223546	224672	1126	125	yes	323316	+
5454	scaffold_32	227898	229213	1315	151	yes	427196	-
5455	scaffold_32	229501	230457	956	64	yes	427196,323319	-,-
5456	scaffold_32	231896	233125	1229	147	yes	323320	+
5457	scaffold_32	238355	238362	7	4	no	NA	NA
5458	scaffold_32	253232	253978	746	52	yes	323347	-
5459	scaffold_32	256780	258905	2125	263	yes	393833	+
5460	scaffold_32	259543	261006	1463	158	no	NA	NA
5461	scaffold_32	261300	262497	1197	142	no	NA	NA
5462	scaffold_32	274028	275405	1377	148	no	NA	NA
5463	scaffold_32	277130	277896	766	92	yes	103149	+
5464	scaffold_32	278784	279903	1119	135	yes	323360	+
5465	scaffold_32	287047	287077	30	8	no	NA	NA
5466	scaffold_32	287363	288598	1235	131	yes	296720,323363	-,+
5467	scaffold_32	288727	289768	1041	94	yes	323363	+
5468	scaffold_32	291478	293008	1530	142	yes	323364	-
5469	scaffold_32	301144	301754	610	82	no	NA	NA
5470	scaffold_32	301827	302450	623	56	yes	323369	-
5471	scaffold_32	303298	304437	1139	113	yes	323371	+
5472	scaffold_32	318856	320008	1152	109	no	NA	NA
5473	scaffold_32	322834	323925	1091	144	yes	427213	+
5474	scaffold_32	338327	339845	1518	192	yes	323383	+
5475	scaffold_32	342475	344023	1548	158	yes	323386	-
5476	scaffold_32	347513	348971	1458	169	yes	246242	-
5477	scaffold_32	351889	352694	805	105	no	NA	NA
5478	scaffold_32	354952	356191	1239	149	yes	296735	+
5479	scaffold_32	360581	361692	1111	126	yes	427220	-
5480	scaffold_32	372755	374188	1433	182	no	NA	NA
5481	scaffold_32	407220	408410	1190	133	yes	323406	+
5482	scaffold_32	418171	419321	1150	78	yes	323410	-
5483	scaffold_32	423669	424846	1177	128	yes	323412,427227	+,+
5484	scaffold_32	425322	426446	1124	128	yes	323412,323415	+,+
5485	scaffold_32	426862	427912	1050	141	yes	323415	+
5486	scaffold_32	433628	435104	1476	156	yes	323417	-
5487	scaffold_32	440206	441132	926	116	yes	323421,393863	+,+
5488	scaffold_32	441454	442197	743	75	yes	323421	+
5489	scaffold_32	447993	449188	1195	177	yes	103568	-
5490	scaffold_32	452227	453094	867	118	yes	323427	-
5491	scaffold_32	453291	453438	147	6	no	NA	NA
5492	scaffold_32	454347	454754	407	39	yes	323432	+
5493	scaffold_32	456859	457645	786	76	yes	323433	-
5494	scaffold_32	457822	458448	626	87	yes	323433	-
5495	scaffold_32	460624	461922	1298	129	yes	233861,323438	-,+
5496	scaffold_32	462475	464172	1697	202	yes	233861,323438	-,+
5497	scaffold_32	464435	465542	1107	105	yes	323439	-
5498	scaffold_32	469958	471318	1360	168	yes	323441	+
5499	scaffold_32	472088	473081	993	89	no	NA	NA
5500	scaffold_32	476004	476918	914	92	yes	246280	-
5501	scaffold_32	495930	496253	323	31	yes	103760	+
5502	scaffold_32	506857	509181	2324	285	no	NA	NA
5503	scaffold_32	523012	524045	1033	119	yes	233872	-
5504	scaffold_32	533669	534414	745	92	yes	323459	+
5505	scaffold_32	546277	547348	1071	96	yes	233876	+
5506	scaffold_32	557717	558821	1104	114	yes	103849,246292	+,-
5507	scaffold_32	559113	560091	978	122	yes	103849,246292	+,-
5508	scaffold_32	562384	563705	1321	152	yes	427256	+
5509	scaffold_32	565398	566554	1156	121	yes	233886,323471	-,+
5510	scaffold_32	576747	577924	1177	99	yes	403715	+
5511	scaffold_32	593156	594409	1253	133	yes	403717	-
5512	scaffold_32	599294	599320	26	10	no	NA	NA
5513	scaffold_32	603520	604561	1041	116	yes	323485	+
5514	scaffold_32	614245	616854	2609	230	yes	323501,393892	+,-
5515	scaffold_32	621808	622846	1038	107	yes	323503	+
5516	scaffold_32	630384	631495	1111	115	yes	323508	+
5517	scaffold_32	635087	636161	1074	71	yes	323510	+
5518	scaffold_32	638015	639254	1239	139	yes	296789	-
5519	scaffold_32	642167	643138	971	114	yes	403731	-
5520	scaffold_32	644097	645304	1207	133	yes	323518	+
5521	scaffold_32	652161	653344	1183	88	yes	233911	-
5522	scaffold_32	655455	656666	1211	124	yes	323522	+
5523	scaffold_32	677990	679026	1036	148	yes	403736	-
5524	scaffold_32	679276	680476	1200	106	yes	323539,393904	+,-
5525	scaffold_32	680705	681843	1138	139	yes	323539,393904	+,-
5526	scaffold_32	688490	689513	1023	104	yes	220424	-
5527	scaffold_32	690112	690120	8	4	no	NA	NA
5528	scaffold_32	699695	700924	1229	142	yes	323546	+
5529	scaffold_32	708896	709646	750	91	yes	323549	+
5530	scaffold_32	713707	714592	885	51	yes	323551	-
5531	scaffold_32	714817	714825	8	4	no	NA	NA
5532	scaffold_32	720355	721467	1112	103	yes	403746	-
5533	scaffold_32	726272	727286	1014	101	yes	323553	+
5534	scaffold_32	739480	740489	1009	136	yes	323560	-
5535	scaffold_32	755130	756402	1272	129	yes	246343,393921	-,+
5536	scaffold_32	756562	756581	19	5	no	NA	NA
5537	scaffold_32	759514	760605	1091	131	yes	393922	-
5538	scaffold_32	761920	762732	812	114	no	NA	NA
5539	scaffold_32	767585	768970	1385	182	yes	104453	+
5540	scaffold_32	776183	777712	1529	132	yes	403757	-
5541	scaffold_32	781267	782833	1566	176	yes	403758	-
5542	scaffold_32	783755	784691	936	122	yes	323581	+
5543	scaffold_32	787733	789394	1661	203	yes	393928	-
5544	scaffold_32	790248	791910	1662	184	yes	323585	+
5545	scaffold_32	794369	795224	855	109	yes	393930	+
5546	scaffold_32	797806	798023	217	30	no	NA	NA
5547	scaffold_32	798168	798997	829	108	yes	296826	-
5548	scaffold_32	803624	804764	1140	113	yes	296827	-
5549	scaffold_32	806061	806243	182	11	no	NA	NA
5550	scaffold_32	812801	813366	565	39	yes	104605	-
5551	scaffold_32	815887	815893	6	4	no	NA	NA
5552	scaffold_32	817099	818482	1383	83	yes	104625	+
5553	scaffold_32	828517	829785	1268	105	yes	323598,403768	-,+
5554	scaffold_32	833880	835186	1306	131	yes	220390	+
5555	scaffold_32	836965	838300	1335	170	yes	323601	-
5556	scaffold_32	840972	842269	1297	135	yes	296832	+
5557	scaffold_32	855641	855793	152	17	no	NA	NA
5558	scaffold_33	5486	6921	1435	146	yes	427312	+
5559	scaffold_33	10570	11789	1219	181	yes	323606	+
5560	scaffold_33	19476	20874	1398	91	yes	427314	+
5561	scaffold_33	28063	29560	1497	180	yes	296839	-
5562	scaffold_33	29862	30601	739	76	yes	296839	-
5563	scaffold_33	35797	36725	928	118	yes	104954	-
5564	scaffold_33	37031	37823	792	72	no	NA	NA
5565	scaffold_33	57623	58103	480	30	no	NA	NA
5566	scaffold_33	58313	58373	60	10	yes	220714	+
5567	scaffold_33	63160	64666	1506	170	yes	323626	+
5568	scaffold_33	67339	68199	860	38	yes	393946	-
5569	scaffold_33	77090	77909	819	92	yes	323635	-
5570	scaffold_33	80203	81164	961	71	no	NA	NA
5571	scaffold_33	81287	81303	16	6	no	NA	NA
5572	scaffold_33	94092	95214	1122	143	yes	374931,406952	-,+
5573	scaffold_33	106728	107047	319	23	yes	393952	+
5574	scaffold_33	115255	116323	1068	101	yes	233965	-
5575	scaffold_33	125677	126649	972	100	yes	427327	+
5576	scaffold_33	169678	169765	87	10	yes	323650	+
5577	scaffold_33	173874	174540	666	89	yes	323652,406973	-,+
5578	scaffold_33	182457	183244	787	79	no	NA	NA
5579	scaffold_33	184380	185036	656	85	no	NA	NA
5580	scaffold_33	185316	185322	6	4	no	NA	NA
5581	scaffold_33	186305	187200	895	77	no	NA	NA
5582	scaffold_33	190677	191423	746	79	yes	296868	-
5583	scaffold_33	197939	198702	763	116	yes	406979	-
5584	scaffold_33	200492	201585	1093	125	yes	323661	-
5585	scaffold_33	202980	203209	229	26	no	NA	NA
5586	scaffold_33	207515	209356	1841	237	yes	323662	-
5587	scaffold_33	211680	213157	1477	109	yes	296873	+
5588	scaffold_33	213383	213543	160	12	yes	296873	+
5589	scaffold_33	215996	217219	1223	151	yes	323666	+
5590	scaffold_33	221796	222673	877	117	yes	323668,393972	-,+
5591	scaffold_33	222995	223776	781	116	yes	323668,393972	-,+
5592	scaffold_33	232285	233394	1109	180	yes	393975	-
5593	scaffold_33	233536	234759	1223	92	yes	393975	-
5594	scaffold_33	238807	238869	62	16	no	NA	NA
5595	scaffold_33	240137	241397	1260	150	yes	105317	+
5596	scaffold_33	245524	246601	1077	90	yes	393978	-
5597	scaffold_33	248020	248990	970	114	yes	233985	+
5598	scaffold_33	253177	254849	1672	161	yes	105368	-
5599	scaffold_33	255865	257235	1370	167	yes	406995	+
5600	scaffold_33	261483	262263	780	93	yes	323691	-
5601	scaffold_33	264500	266080	1580	123	yes	366006	+
5602	scaffold_33	268826	268863	37	6	no	NA	NA
5603	scaffold_33	269158	270094	936	139	yes	323700	-
5604	scaffold_33	277755	279306	1551	187	yes	393988	-
5605	scaffold_33	282499	283464	965	132	yes	323706	-
5606	scaffold_33	284181	285349	1168	132	yes	323708	+
5607	scaffold_33	286567	287875	1308	171	yes	407003	+
5608	scaffold_33	293717	293723	6	4	yes	105693	-
5609	scaffold_33	294134	295314	1180	104	no	NA	NA
5610	scaffold_33	300803	301586	783	65	no	NA	NA
5611	scaffold_33	322772	324032	1260	104	yes	323725	+
5612	scaffold_33	347018	348043	1025	144	yes	394001	-
5613	scaffold_33	352077	352102	25	4	yes	323732	+
5614	scaffold_33	352187	353013	826	82	yes	323732	+
5615	scaffold_33	353556	353574	18	6	no	NA	NA
5616	scaffold_33	353947	354015	68	11	yes	323733	-
5617	scaffold_33	357482	358807	1325	142	yes	246424	-
5618	scaffold_33	361655	361908	253	26	yes	220618	+
5619	scaffold_33	361978	362060	82	10	yes	220618	+
5620	scaffold_33	363268	363289	21	6	no	NA	NA
5621	scaffold_33	363848	364761	913	114	no	NA	NA
5622	scaffold_33	367743	369093	1350	163	yes	323742	-
5623	scaffold_33	375581	376472	891	99	no	NA	NA
5624	scaffold_33	382759	384083	1324	144	no	NA	NA
5625	scaffold_33	385907	387407	1500	123	yes	366010	+
5626	scaffold_33	387965	388015	50	12	no	NA	NA
5627	scaffold_33	388203	389284	1081	88	yes	323750	-
5628	scaffold_33	390293	391522	1229	156	yes	323753	+
5629	scaffold_33	397963	399347	1384	130	yes	407031	-
5630	scaffold_33	423108	424464	1356	146	yes	323767	-
5631	scaffold_33	435044	436484	1440	153	no	NA	NA
5632	scaffold_33	437529	438565	1036	124	yes	323774	-
5633	scaffold_33	439869	441110	1241	136	yes	296932	+
5634	scaffold_33	445775	446977	1202	167	yes	394025	-
5635	scaffold_33	457515	458678	1163	121	yes	407043	+
5636	scaffold_33	461032	462103	1071	152	yes	323793,427399	+,-
5637	scaffold_33	471917	472920	1003	128	yes	394032	-
5638	scaffold_33	476025	477659	1634	141	yes	394033	-
5639	scaffold_33	481839	481848	9	4	no	NA	NA
5640	scaffold_33	482058	482122	64	8	no	NA	NA
5641	scaffold_33	482234	482974	740	52	yes	323802	-
5642	scaffold_33	488711	489801	1090	168	no	NA	NA
5643	scaffold_33	493441	494249	808	50	yes	296944	-
5644	scaffold_33	498875	499692	817	96	yes	296945	-
5645	scaffold_33	504826	505617	791	83	yes	427407	-
5646	scaffold_33	511088	511096	8	4	no	NA	NA
5647	scaffold_33	511315	512365	1050	87	yes	407053	-
5648	scaffold_33	517556	518571	1015	79	yes	394037	-
5649	scaffold_33	526243	527496	1253	141	yes	323816	-
5650	scaffold_33	535910	536733	823	100	yes	394041	-
5651	scaffold_33	540628	541496	868	77	yes	407060	-
5652	scaffold_33	546003	546016	13	6	no	NA	NA
5653	scaffold_33	546345	546390	45	12	yes	394043	-
5654	scaffold_33	552251	553400	1149	171	yes	375020	+
5655	scaffold_33	557752	558887	1135	135	yes	323834	+
5656	scaffold_33	562418	562933	515	58	no	NA	NA
5657	scaffold_33	593048	594033	985	117	yes	106295	-
5658	scaffold_33	597281	598414	1133	124	yes	296963	+
5659	scaffold_33	602122	603394	1272	155	yes	427424	+
5660	scaffold_33	608802	609998	1196	130	yes	407073	-
5661	scaffold_33	610578	610733	155	22	no	NA	NA
5662	scaffold_33	610845	610858	13	4	no	NA	NA
5663	scaffold_33	619429	620348	919	84	yes	220629	-
5664	scaffold_33	632020	632858	838	82	yes	323863	-
5665	scaffold_33	638956	640386	1430	148	yes	407078	-
5666	scaffold_33	642079	643258	1179	151	yes	323866	-
5667	scaffold_33	643757	644910	1153	105	yes	220620	+
5668	scaffold_33	650915	652460	1545	180	yes	106507	-
5669	scaffold_33	656247	657381	1134	143	yes	323876,323879	-,+
5670	scaffold_33	657894	659125	1231	134	yes	323879	+
5671	scaffold_33	659976	661167	1191	161	yes	220717	+
5672	scaffold_33	672473	673585	1112	141	yes	246493,323886	-,+
5673	scaffold_33	673838	675151	1313	126	yes	246493,323886	-,+
5674	scaffold_33	682753	683819	1066	158	yes	375052	-
5675	scaffold_33	692299	693188	889	90	no	NA	NA
5676	scaffold_33	704915	706840	1925	221	yes	407094	-
5677	scaffold_33	712398	712873	475	53	yes	296994	+
5678	scaffold_33	713175	713240	65	16	yes	296994	+
5679	scaffold_33	713315	713370	55	3	yes	296994	+
5680	scaffold_33	718398	718423	25	10	yes	234081	-
5681	scaffold_33	734983	735963	980	123	yes	106726	+
5682	scaffold_33	742708	743220	512	56	yes	323913	-
5683	scaffold_33	756663	757451	788	86	yes	394082	-
5684	scaffold_33	765390	766260	870	103	no	NA	NA
5685	scaffold_33	767198	768978	1780	163	no	NA	NA
5686	scaffold_33	770924	771973	1049	107	yes	297006	+
5687	scaffold_33	778863	778880	17	8	yes	323922	+
5688	scaffold_33	781014	782590	1576	130	yes	323926,323927	+,+
5689	scaffold_33	782796	783396	600	53	yes	323927	+
5690	scaffold_33	783529	783548	19	6	no	NA	NA
5691	scaffold_33	791898	793052	1154	183	yes	323931	+
5692	scaffold_33	798790	800478	1688	156	no	NA	NA
5693	scaffold_33	812393	813434	1041	84	yes	407115	-
5694	scaffold_33	816669	818057	1388	112	yes	323938	-
5695	scaffold_33	821267	821314	47	10	no	NA	NA
5696	scaffold_33	821421	821795	374	52	yes	323940	-
5697	scaffold_33	826423	827590	1167	125	yes	323942	+
5698	scaffold_33	842231	843356	1125	112	yes	107144	-
5699	scaffold_33	844611	844766	155	24	no	NA	NA
5700	scaffold_33	844878	844910	32	5	no	NA	NA
5701	scaffold_257	4367	4386	19	6	no	NA	NA
5702	scaffold_257	7623	7642	19	6	no	NA	NA
5703	scaffold_257	8119	8146	27	10	no	NA	NA
5704	scaffold_257	11274	11312	38	11	no	NA	NA
5705	scaffold_34	22895	23258	363	36	yes	394101	-
5706	scaffold_34	30774	30985	211	22	yes	323954	-
5707	scaffold_34	31746	31971	225	17	yes	297030	+
5708	scaffold_34	85801	86516	715	30	yes	211923,323979,323981	+,+,+
5709	scaffold_34	98988	99209	221	26	no	NA	NA
5710	scaffold_34	100603	101846	1243	116	yes	323983	+
5711	scaffold_34	103215	103646	431	45	yes	427482	-
5712	scaffold_34	104066	105003	937	105	yes	427482	-
5713	scaffold_34	105431	105463	32	7	yes	410046	-
5714	scaffold_34	126877	127824	947	117	yes	323999	+
5715	scaffold_34	131213	131687	474	56	yes	375140	+
5716	scaffold_34	160263	160270	7	4	yes	107697	+
5717	scaffold_34	160474	160491	17	4	yes	107697	+
5718	scaffold_34	185493	186960	1467	191	no	NA	NA
5719	scaffold_34	193422	194793	1371	170	yes	324024	+
5720	scaffold_34	203515	204788	1273	124	no	NA	NA
5721	scaffold_34	209290	210591	1301	136	yes	324035	-
5722	scaffold_34	211172	212105	933	102	yes	297067	+
5723	scaffold_34	228022	228518	496	40	yes	394132	+
5724	scaffold_34	253099	253155	56	13	yes	324048	+
5725	scaffold_34	255434	255445	11	4	no	NA	NA
5726	scaffold_34	263850	263956	106	15	yes	246545	+
5727	scaffold_34	270761	272084	1323	110	yes	107845	+
5728	scaffold_34	343904	345105	1201	132	yes	107909	+
5729	scaffold_34	379245	380116	871	82	yes	427519	+
5730	scaffold_34	380238	380261	23	8	no	NA	NA
5731	scaffold_34	391269	391441	172	17	yes	394145	+
5732	scaffold_34	391879	391897	18	4	no	NA	NA
5733	scaffold_34	392011	392020	9	6	no	NA	NA
5734	scaffold_34	392270	392323	53	10	no	NA	NA
5735	scaffold_34	400531	400581	50	11	no	NA	NA
5736	scaffold_34	400703	401232	529	66	yes	297093	-
5737	scaffold_34	408199	408259	60	14	no	NA	NA
5738	scaffold_34	408359	408438	79	10	no	NA	NA
5739	scaffold_34	448237	448449	212	18	no	NA	NA
5740	scaffold_34	502620	502636	16	4	no	NA	NA
5741	scaffold_34	527270	527297	27	6	no	NA	NA
5742	scaffold_34	567275	567298	23	8	yes	394172	-
5743	scaffold_34	591005	592018	1013	104	no	NA	NA
5744	scaffold_34	598846	599149	303	26	yes	375230	+
5745	scaffold_34	716980	717146	166	34	no	NA	NA
5746	scaffold_34	717264	717322	58	16	yes	410199	-
5747	scaffold_34	722572	722646	74	22	no	NA	NA
5748	scaffold_34	735951	736007	56	9	no	NA	NA
5749	scaffold_34	736158	736181	23	8	yes	410204	+
5750	scaffold_34	738537	738581	44	8	no	NA	NA
5751	scaffold_34	739967	740166	199	22	no	NA	NA
5752	scaffold_34	740263	740319	56	14	no	NA	NA
5753	scaffold_34	743615	743818	203	22	no	NA	NA
5754	scaffold_34	743931	743968	37	12	no	NA	NA
5755	scaffold_34	752759	752878	119	19	yes	410206	+
5756	scaffold_34	754498	756473	1975	218	no	NA	NA
5757	scaffold_34	756603	756617	14	6	no	NA	NA
5758	scaffold_34	757514	757975	461	60	no	NA	NA
5759	scaffold_34	768090	768110	20	3	no	NA	NA
5760	scaffold_34	768260	768274	14	6	no	NA	NA
5761	scaffold_34	768642	769629	987	119	yes	427557	+
5762	scaffold_34	800022	800031	9	4	no	NA	NA
5763	scaffold_34	802195	802233	38	13	no	NA	NA
5764	scaffold_34	807283	807430	147	20	yes	375281	-
5765	scaffold_34	808404	808435	31	7	no	NA	NA
5766	scaffold_34	815759	815766	7	4	no	NA	NA
5767	scaffold_34	815958	816545	587	49	no	NA	NA
5768	scaffold_34	816656	817623	967	132	no	NA	NA
5769	scaffold_235	7958	8019	61	14	no	NA	NA
5770	scaffold_235	9338	9971	633	73	no	NA	NA
5771	scaffold_35	23251	23556	305	26	yes	394191	+
5772	scaffold_35	28629	29661	1032	76	yes	427567	-
5773	scaffold_35	33717	34596	879	125	no	NA	NA
5774	scaffold_35	35716	38292	2576	295	yes	324153	+
5775	scaffold_35	60511	62261	1750	163	yes	220856	-
5776	scaffold_35	65341	66841	1500	192	yes	403400	+
5777	scaffold_35	76340	76559	219	13	no	NA	NA
5778	scaffold_35	76643	76886	243	20	no	NA	NA
5779	scaffold_35	77282	78319	1037	78	no	NA	NA
5780	scaffold_35	79832	80957	1125	122	yes	108739	+
5781	scaffold_35	88048	89579	1531	155	yes	297189	-
5782	scaffold_35	90921	91827	906	98	yes	324167	+
5783	scaffold_35	92020	93191	1171	137	yes	324167	+
5784	scaffold_35	98931	100522	1591	211	yes	234171	-
5785	scaffold_35	111264	112856	1592	171	yes	324174	-
5786	scaffold_35	118797	120246	1449	137	yes	403408	+
5787	scaffold_35	131622	132673	1051	126	yes	394208	+
5788	scaffold_35	132755	132812	57	8	no	NA	NA
5789	scaffold_35	139256	140351	1095	129	yes	324179	+
5790	scaffold_35	162235	163595	1360	164	yes	108935,394214	-,+
5791	scaffold_35	163779	164709	930	99	yes	108935,394214	-,+
5792	scaffold_35	167798	169262	1464	200	yes	394216	+
5793	scaffold_35	201124	202279	1155	97	yes	324198	-
5794	scaffold_35	203197	203442	245	10	no	NA	NA
5795	scaffold_35	210978	212295	1317	146	yes	394220	-
5796	scaffold_35	214980	216279	1299	155	yes	324200	+
5797	scaffold_35	221563	222692	1129	131	no	NA	NA
5798	scaffold_35	223260	224399	1139	144	yes	324204	+
5799	scaffold_35	229981	230476	495	38	yes	324207	-
5800	scaffold_35	231142	232293	1151	160	yes	324210	+
5801	scaffold_35	243642	244329	687	41	yes	324215	+
5802	scaffold_35	249863	251352	1489	171	yes	394228	+
5803	scaffold_35	263601	263629	28	10	no	NA	NA
5804	scaffold_35	315057	316091	1034	134	yes	109256	-
5805	scaffold_35	316412	317517	1105	90	yes	109256	-
5806	scaffold_35	319033	319614	581	55	yes	403456	+
5807	scaffold_35	322396	322562	166	12	no	NA	NA
5808	scaffold_35	323072	323199	127	5	no	NA	NA
5809	scaffold_35	325958	327439	1481	161	yes	109296,324293	+,+
5810	scaffold_35	327755	329213	1458	144	yes	324293	+
5811	scaffold_35	333650	334983	1333	152	yes	109326	-
5812	scaffold_35	342712	342717	5	3	no	NA	NA
5813	scaffold_35	342809	344053	1244	136	yes	324306	-
5814	scaffold_35	345418	345514	96	19	no	NA	NA
5815	scaffold_35	345638	345902	264	28	no	NA	NA
5816	scaffold_35	346048	346116	68	8	no	NA	NA
5817	scaffold_35	346275	347363	1088	120	yes	324308	-
5818	scaffold_35	368945	368955	10	4	no	NA	NA
5819	scaffold_35	370694	371829	1135	142	no	NA	NA
5820	scaffold_35	373156	374901	1745	206	no	NA	NA
5821	scaffold_35	375657	376191	534	54	no	NA	NA
5822	scaffold_35	376323	376360	37	4	no	NA	NA
5823	scaffold_35	378669	380211	1542	167	yes	324315	-
5824	scaffold_35	380422	381555	1133	124	yes	324315,427620	-,+
5825	scaffold_35	381675	383048	1373	141	yes	427620	+
5826	scaffold_35	392434	393679	1245	108	yes	324320	-
5827	scaffold_35	396875	398014	1139	82	yes	324322	-
5828	scaffold_35	507185	507829	644	67	yes	109574	-
5829	scaffold_35	510042	510155	113	13	no	NA	NA
5830	scaffold_35	510293	510860	567	55	no	NA	NA
5831	scaffold_35	517095	517593	498	43	yes	109596	-
5832	scaffold_35	525024	525098	74	18	no	NA	NA
5833	scaffold_35	560967	561933	966	101	yes	109683	+
5834	scaffold_35	566010	566924	914	81	yes	375396	+
5835	scaffold_35	570949	571570	621	67	yes	394271	+
5836	scaffold_35	575125	575851	726	85	yes	394272	+
5837	scaffold_35	603775	603821	46	4	yes	109714	+
5838	scaffold_35	603923	604423	500	40	no	NA	NA
5839	scaffold_35	604531	604574	43	12	no	NA	NA
5840	scaffold_35	608153	608486	333	46	no	NA	NA
5841	scaffold_35	608604	608664	60	10	no	NA	NA
5842	scaffold_35	608791	608812	21	6	no	NA	NA
5843	scaffold_35	633207	633361	154	20	no	NA	NA
5844	scaffold_35	633457	633671	214	34	no	NA	NA
5845	scaffold_35	639713	640742	1029	90	yes	109748	-
5846	scaffold_35	640941	641021	80	12	no	NA	NA
5847	scaffold_35	653127	655008	1881	172	yes	427661	+
5848	scaffold_35	655316	656526	1210	158	yes	427661	+
5849	scaffold_35	662604	663916	1312	133	yes	394283	+
5850	scaffold_35	668508	669072	564	46	yes	324419	+
5851	scaffold_35	686536	687808	1272	154	no	NA	NA
5852	scaffold_35	692819	693115	296	21	yes	109849	+
5853	scaffold_35	696566	697112	546	65	no	NA	NA
5854	scaffold_35	710815	711519	704	91	yes	324427	+
5855	scaffold_35	722545	722587	42	4	no	NA	NA
5856	scaffold_35	722662	723670	1008	143	yes	394291	-
5857	scaffold_35	741699	741779	80	14	yes	324437	+
5858	scaffold_35	741878	742000	122	12	yes	324437	+
5859	scaffold_35	742158	742175	17	4	no	NA	NA
5860	scaffold_35	742286	742315	29	6	no	NA	NA
5861	scaffold_35	751302	753038	1736	206	yes	375460,394296	+,-
5862	scaffold_35	770263	770889	626	29	yes	324451	+
5863	scaffold_35	773194	773449	255	27	yes	394301	+
5864	scaffold_35	794577	795365	788	80	yes	109966	-
5865	scaffold_35	799345	799613	268	33	yes	234306	+
5866	scaffold_35	799953	799962	9	4	no	NA	NA
5867	scaffold_35	802217	803155	938	121	no	NA	NA
5868	scaffold_35	804104	804814	710	74	yes	427690	-
5869	scaffold_35	810571	811209	638	76	yes	324466,427694	-,+
5870	scaffold_35	817314	818238	924	121	yes	375485	-
5871	scaffold_368	1289	1926	637	42	no	NA	NA
5872	scaffold_300	6781	7215	434	45	no	NA	NA
5873	scaffold_36	9904	11289	1385	147	yes	324471,324473	+,+
5874	scaffold_36	11551	12782	1231	116	yes	324473	+
5875	scaffold_36	29847	30487	640	31	yes	297334	+
5876	scaffold_36	30674	30850	176	14	yes	297334	+
5877	scaffold_36	34220	34344	124	8	yes	324477	+
5878	scaffold_36	79709	79712	3	3	yes	324487	-
5879	scaffold_36	81870	83029	1159	148	yes	324490	-
5880	scaffold_36	85030	85797	767	83	yes	324492	+
5881	scaffold_36	113577	113784	207	18	yes	246748	+
5882	scaffold_36	133504	134042	538	46	yes	297354	+
5883	scaffold_36	135585	136179	594	77	yes	110358	+
5884	scaffold_36	138136	138480	344	29	yes	324516	+
5885	scaffold_36	143592	144870	1278	188	yes	221070	-
5886	scaffold_36	154357	155175	818	87	yes	221051	+
5887	scaffold_36	167357	167740	383	18	yes	402093	-
5888	scaffold_36	200120	200307	187	24	no	NA	NA
5889	scaffold_36	200455	201055	600	70	no	NA	NA
5890	scaffold_36	202457	203381	924	93	yes	324540	+
5891	scaffold_36	208713	208760	47	10	yes	394346	+
5892	scaffold_36	214741	216125	1384	166	yes	221093	+
5893	scaffold_36	218684	219461	777	85	yes	402105	+
5894	scaffold_36	222024	222839	815	80	yes	324555	+
5895	scaffold_36	232052	233539	1487	154	no	NA	NA
5896	scaffold_36	233952	233961	9	4	no	NA	NA
5897	scaffold_36	241331	242579	1248	106	yes	221010	-
5898	scaffold_36	244805	246071	1266	180	yes	324560	+
5899	scaffold_36	247202	249006	1804	162	yes	297375	-
5900	scaffold_36	257458	258537	1079	88	yes	324564	+
5901	scaffold_36	260091	260775	684	62	yes	246791	-
5902	scaffold_36	267558	268648	1090	122	yes	246794	-
5903	scaffold_36	278202	278315	113	5	yes	324576	-
5904	scaffold_36	282177	282861	684	67	yes	324578,324580	-,+
5905	scaffold_36	283143	283974	831	123	yes	324578,324580	-,+
5906	scaffold_36	285971	286751	780	99	yes	246796	-
5907	scaffold_36	287015	289382	2367	282	yes	246796,324584	-,-
5908	scaffold_36	303214	304336	1122	116	yes	324591	-
5909	scaffold_36	307588	308903	1315	133	yes	324592	-
5910	scaffold_36	312374	313146	772	47	yes	324593	+
5911	scaffold_36	317003	318223	1220	93	no	NA	NA
5912	scaffold_36	318447	318454	7	4	no	NA	NA
5913	scaffold_36	322754	323714	960	118	yes	324606	+
5914	scaffold_36	329096	329104	8	4	yes	324610	+
5915	scaffold_36	329279	330686	1407	156	yes	324610	+
5916	scaffold_36	333955	335184	1229	146	yes	110924	-
5917	scaffold_36	345626	346906	1280	95	yes	394379	-
5918	scaffold_36	349077	350175	1098	133	yes	324621	+
5919	scaffold_36	351315	352355	1040	105	yes	324625	+
5920	scaffold_36	357993	359474	1481	131	yes	324629	-
5921	scaffold_36	365784	366545	761	58	yes	394384	+
5922	scaffold_36	369774	371292	1518	166	yes	402141	+
5923	scaffold_36	392882	393829	947	96	yes	324640	+
5924	scaffold_36	408259	409372	1113	137	yes	427768	+
5925	scaffold_36	409484	409607	123	16	yes	427768	+
5926	scaffold_36	413576	414566	990	125	yes	427769	-
5927	scaffold_36	429740	429827	87	22	no	NA	NA
5928	scaffold_36	440813	440829	16	4	no	NA	NA
5929	scaffold_36	440912	440952	40	12	yes	427773	-
5930	scaffold_36	446461	447954	1493	142	yes	324650,394395	+,+
5931	scaffold_36	462358	462389	31	4	yes	297429	-
5932	scaffold_36	462644	463251	607	52	yes	297429	-
5933	scaffold_36	475963	476802	839	119	yes	394399	-
5934	scaffold_36	480651	481930	1279	165	yes	111573	+
5935	scaffold_36	488882	489768	886	55	yes	427781	-
5936	scaffold_36	497746	498246	500	18	yes	221124	+
5937	scaffold_36	503860	505102	1242	97	yes	111657	+
5938	scaffold_36	514538	514645	107	12	no	NA	NA
5939	scaffold_36	514769	515120	351	37	no	NA	NA
5940	scaffold_36	517370	518535	1165	121	yes	324683	-
5941	scaffold_36	522691	523942	1251	140	yes	394407	-
5942	scaffold_36	526111	526952	841	85	yes	394408	-
5943	scaffold_36	528687	529368	681	75	no	NA	NA
5944	scaffold_36	535088	535889	801	110	yes	324694,324696	-,+
5945	scaffold_36	539413	540421	1008	124	yes	324698	-
5946	scaffold_36	549212	550636	1424	161	yes	246829	-
5947	scaffold_36	554477	555156	679	62	yes	234409	-
5948	scaffold_36	559070	560539	1469	161	yes	402183	+
5949	scaffold_36	560704	560708	4	4	no	NA	NA
5950	scaffold_36	571131	572114	983	126	yes	324711	-
5951	scaffold_36	577606	579243	1637	135	no	NA	NA
5952	scaffold_36	581529	582862	1333	144	yes	324717	-
5953	scaffold_36	590583	591567	984	108	yes	394422	-
5954	scaffold_36	594428	595366	938	98	yes	402190	+
5955	scaffold_36	598263	599802	1539	156	no	NA	NA
5956	scaffold_36	603229	604810	1581	116	yes	402193	-
5957	scaffold_36	621455	623796	2341	192	yes	394425	-
5958	scaffold_36	636516	637579	1063	105	yes	324729	+
5959	scaffold_36	639991	640837	846	106	no	NA	NA
5960	scaffold_36	661272	662365	1093	99	yes	324758	+
5961	scaffold_36	667892	669302	1410	138	yes	297472	-
5962	scaffold_36	674235	675547	1312	163	yes	324767,324769	-,+
5963	scaffold_36	675922	676737	815	109	yes	324767,324769	-,+
5964	scaffold_36	683764	683787	23	4	yes	112094	-
5965	scaffold_36	683883	684361	478	34	yes	112094	-
5966	scaffold_36	686354	687959	1605	149	yes	297477	+
5967	scaffold_36	707398	709211	1813	211	yes	221155	+
5968	scaffold_36	719656	720639	983	148	yes	324780	-
5969	scaffold_36	722820	723000	180	15	yes	112142	-
5970	scaffold_36	724422	726093	1671	195	yes	324783	+
5971	scaffold_36	736412	737892	1480	99	yes	112247	+
5972	scaffold_36	743783	744737	954	118	yes	427826	-
5973	scaffold_36	746755	748145	1390	187	yes	234460	-
5974	scaffold_36	780076	780236	160	18	no	NA	NA
5975	scaffold_36	790579	791796	1217	108	no	NA	NA
5976	scaffold_36	799559	799573	14	5	no	NA	NA
5977	scaffold_36	800051	800061	10	3	no	NA	NA
5978	scaffold_172	25632	25680	48	12	no	NA	NA
5979	scaffold_336	749	759	10	2	no	NA	NA
5980	scaffold_37	31085	31099	14	6	no	NA	NA
5981	scaffold_37	79783	80512	729	56	no	NA	NA
5982	scaffold_37	112039	112048	9	4	no	NA	NA
5983	scaffold_37	126945	127005	60	12	no	NA	NA
5984	scaffold_37	128921	128956	35	7	no	NA	NA
5985	scaffold_37	136965	138218	1253	109	no	NA	NA
5986	scaffold_37	156067	156850	783	56	no	NA	NA
5987	scaffold_37	159560	159565	5	4	no	NA	NA
5988	scaffold_37	162071	162095	24	12	no	NA	NA
5989	scaffold_37	162253	162504	251	23	no	NA	NA
5990	scaffold_37	176364	177063	699	104	no	NA	NA
5991	scaffold_37	177189	177210	21	8	no	NA	NA
5992	scaffold_37	181342	181963	621	106	no	NA	NA
5993	scaffold_37	182106	182732	626	40	no	NA	NA
5994	scaffold_37	199153	199224	71	8	yes	375681	-
5995	scaffold_37	203908	203966	58	8	yes	394459	-
5996	scaffold_37	207243	207262	19	4	no	NA	NA
5997	scaffold_37	212156	212168	12	6	yes	416768	-
5998	scaffold_37	216417	216426	9	4	yes	427840	-
5999	scaffold_37	221190	221261	71	12	no	NA	NA
6000	scaffold_37	225599	225683	84	18	yes	427841	-
6001	scaffold_37	230607	230657	50	10	yes	297513	-
6002	scaffold_37	240340	240899	559	62	no	NA	NA
6003	scaffold_37	241000	241027	27	5	no	NA	NA
6004	scaffold_37	241321	241364	43	6	no	NA	NA
6005	scaffold_37	241562	241569	7	4	no	NA	NA
6006	scaffold_37	243568	243589	21	8	no	NA	NA
6007	scaffold_37	249418	249470	52	12	no	NA	NA
6008	scaffold_37	254429	255102	673	81	no	NA	NA
6009	scaffold_37	376664	377103	439	48	no	NA	NA
6010	scaffold_37	404238	405721	1483	169	no	NA	NA
6011	scaffold_37	408590	409306	716	44	yes	297552	+
6012	scaffold_37	419089	420130	1041	110	no	NA	NA
6013	scaffold_37	420364	421763	1399	143	no	NA	NA
6014	scaffold_37	447594	447618	24	8	no	NA	NA
6015	scaffold_37	470280	471529	1249	179	no	NA	NA
6016	scaffold_37	471724	471751	27	8	no	NA	NA
6017	scaffold_37	480120	481234	1114	126	yes	427878	+
6018	scaffold_37	481480	482051	571	71	yes	427878	+
6019	scaffold_37	531517	532636	1119	104	no	NA	NA
6020	scaffold_37	533349	533968	619	56	yes	427884	+
6021	scaffold_37	547349	548346	997	123	yes	394491	+
6022	scaffold_37	551105	552683	1578	182	yes	113143	+
6023	scaffold_37	553094	554014	920	74	yes	113143	+
6024	scaffold_37	566798	567125	327	30	no	NA	NA
6025	scaffold_37	571479	572024	545	50	yes	113156	+
6026	scaffold_37	579494	579984	490	49	yes	324916	+
6027	scaffold_37	601182	602135	953	149	yes	324922,394501	-,+
6028	scaffold_37	640101	640906	805	108	yes	427900,427901	+,+
6029	scaffold_37	641045	641091	46	8	yes	427901	+
6030	scaffold_37	645237	647635	2398	260	yes	113238,416899	+,-
6031	scaffold_37	647730	647984	254	18	yes	416899	-
6032	scaffold_37	648687	649804	1117	138	yes	427904	+
6033	scaffold_37	653860	654815	955	101	yes	394511	+
6034	scaffold_37	659689	661901	2212	241	yes	394513,416909	+,+
6035	scaffold_37	662133	662902	769	71	no	NA	NA
6036	scaffold_37	687687	687711	24	4	no	NA	NA
6037	scaffold_153	29552	29814	262	23	yes	432697	+
6038	scaffold_198	9616	10148	532	71	no	NA	NA
6039	scaffold_198	16684	16898	214	32	no	NA	NA
6040	scaffold_198	17006	17046	40	12	no	NA	NA
6041	scaffold_198	17154	17185	31	10	no	NA	NA
6042	scaffold_38	1764	2705	941	104	yes	113437	+
6043	scaffold_38	11871	12848	977	106	yes	402238,402240,427924	+,+,-
6044	scaffold_38	34007	34026	19	8	no	NA	NA
6045	scaffold_38	38706	38921	215	21	yes	113505	-
6046	scaffold_38	55281	55356	75	6	yes	427929	-
6047	scaffold_38	56592	57753	1161	104	yes	324970	+
6048	scaffold_38	58117	59068	951	78	yes	324970	+
6049	scaffold_38	61058	62345	1287	111	no	NA	NA
6050	scaffold_38	63034	63802	768	78	no	NA	NA
6051	scaffold_38	64011	64641	630	69	no	NA	NA
6052	scaffold_38	70172	70291	119	8	no	NA	NA
6053	scaffold_38	72958	72978	20	8	no	NA	NA
6054	scaffold_38	73280	73316	36	8	yes	427933	-
6055	scaffold_38	73403	73420	17	6	yes	427933	-
6056	scaffold_38	78342	79099	757	77	yes	113584	-
6057	scaffold_38	79186	79203	17	6	yes	113584	-
6058	scaffold_38	97901	97924	23	4	no	NA	NA
6059	scaffold_38	100622	102081	1459	205	no	NA	NA
6060	scaffold_38	121011	121245	234	24	no	NA	NA
6061	scaffold_38	121596	121621	25	6	no	NA	NA
6062	scaffold_38	122117	122151	34	10	yes	297635	+
6063	scaffold_38	122478	123368	890	66	yes	297635	+
6064	scaffold_38	129934	130525	591	71	no	NA	NA
6065	scaffold_38	131002	131597	595	63	yes	427938	-
6066	scaffold_38	131682	131733	51	10	yes	427938	-
6067	scaffold_38	154700	154727	27	8	no	NA	NA
6068	scaffold_38	154856	155242	386	42	no	NA	NA
6069	scaffold_38	155384	155397	13	6	no	NA	NA
6070	scaffold_38	159486	160541	1055	119	yes	375929	+
6071	scaffold_38	160616	160653	37	4	no	NA	NA
6072	scaffold_38	166684	166729	45	12	no	NA	NA
6073	scaffold_38	170150	171148	998	107	yes	325008	+
6074	scaffold_38	171406	173161	1755	212	no	NA	NA
6075	scaffold_38	173862	176120	2258	188	no	NA	NA
6076	scaffold_38	180694	180780	86	10	yes	325011	-
6077	scaffold_38	180888	181064	176	26	yes	325011	-
6078	scaffold_38	182416	183559	1143	87	no	NA	NA
6079	scaffold_38	194447	195558	1111	110	yes	394536	-
6080	scaffold_38	204270	204852	582	64	no	NA	NA
6081	scaffold_38	206907	207437	530	55	yes	113776	-
6082	scaffold_38	264569	265345	776	43	no	NA	NA
6083	scaffold_38	265506	265861	355	70	no	NA	NA
6084	scaffold_38	267771	269497	1726	225	yes	113859,325023,394541	-,-,-
6085	scaffold_38	269719	269724	5	4	yes	113859,325023	-,-
6086	scaffold_38	270208	271405	1197	173	yes	325023	-
6087	scaffold_38	282042	282694	652	51	yes	375957	+
6088	scaffold_38	301168	301878	710	95	yes	113899	-
6089	scaffold_38	309667	309809	142	16	yes	325043	-
6090	scaffold_38	310154	311090	936	115	yes	325043	-
6091	scaffold_38	323585	323609	24	4	no	NA	NA
6092	scaffold_38	327782	327802	20	6	no	NA	NA
6093	scaffold_38	327970	328960	990	134	no	NA	NA
6094	scaffold_38	338671	339030	359	44	yes	325063	+
6095	scaffold_38	357091	358260	1169	166	no	NA	NA
6096	scaffold_38	385293	386685	1392	162	no	NA	NA
6097	scaffold_38	428034	429352	1318	156	yes	297685,427967	+,+
6098	scaffold_38	435656	435679	23	8	no	NA	NA
6099	scaffold_38	435853	436761	908	113	yes	427969	-
6100	scaffold_38	439704	441010	1306	139	yes	325100	+
6101	scaffold_38	456472	458392	1920	183	yes	325104	+
6102	scaffold_38	471021	471194	173	26	yes	325106	+
6103	scaffold_38	476426	476826	400	47	no	NA	NA
6104	scaffold_38	477088	477128	40	4	yes	427977	-
6105	scaffold_38	477225	477295	70	16	yes	427977	-
6106	scaffold_38	477479	477490	11	4	yes	427977	-
6107	scaffold_38	487958	488071	113	11	yes	325113	+
6108	scaffold_38	521693	522782	1089	133	yes	114148	-
6109	scaffold_38	526776	528335	1559	172	yes	427988	-
6110	scaffold_38	529238	530905	1667	182	yes	427989	+
6111	scaffold_38	540664	541360	696	62	yes	427991	-
6112	scaffold_38	542867	542947	80	10	no	NA	NA
6113	scaffold_38	543052	543318	266	36	yes	427992	-
6114	scaffold_38	545274	545285	11	3	no	NA	NA
6115	scaffold_38	575773	576149	376	31	no	NA	NA
6116	scaffold_38	576819	576829	10	3	no	NA	NA
6117	scaffold_38	577665	578885	1220	141	no	NA	NA
6118	scaffold_38	588239	588761	522	39	yes	325141	+
6119	scaffold_38	594158	595184	1026	84	yes	428003	+
6120	scaffold_38	598794	600119	1325	160	yes	325145	-
6121	scaffold_38	617417	618556	1139	113	yes	114334	+
6122	scaffold_38	622595	622746	151	12	yes	114346	-
6123	scaffold_38	624512	625293	781	54	yes	246969	+
6124	scaffold_38	656466	657499	1033	130	yes	114372	-
6125	scaffold_38	657815	657834	19	6	yes	114372	-
6126	scaffold_38	657917	657951	34	8	yes	114372	-
6127	scaffold_38	696650	696710	60	22	no	NA	NA
6128	scaffold_38	717695	717814	119	16	no	NA	NA
6129	scaffold_146	6274	6295	21	8	yes	432662	-
6130	scaffold_146	10937	10968	31	8	no	NA	NA
6131	scaffold_146	14755	15896	1141	118	yes	336620	-
6132	scaffold_146	24956	26145	1189	133	yes	336623	-
6133	scaffold_146	32977	34390	1413	202	no	NA	NA
6134	scaffold_146	39802	40320	518	52	yes	366607	-
6135	scaffold_146	40994	41762	768	92	yes	336634	+
6136	scaffold_146	50266	50369	103	6	no	NA	NA
6137	scaffold_214	6405	6424	19	6	no	NA	NA
6138	scaffold_214	9716	9727	11	4	no	NA	NA
6139	scaffold_214	13814	14017	203	8	yes	337265	+
6140	scaffold_271	2290	2312	22	8	no	NA	NA
6141	scaffold_271	2420	2460	40	12	no	NA	NA
6142	scaffold_271	2568	2782	214	30	no	NA	NA
6143	scaffold_271	4772	4791	19	6	no	NA	NA
6144	scaffold_271	8037	8056	19	7	no	NA	NA
6145	scaffold_271	11544	11560	16	5	no	NA	NA
6146	scaffold_39	2842	3336	494	46	no	NA	NA
6147	scaffold_39	7347	8625	1278	117	yes	325204	-
6148	scaffold_39	42876	42940	64	14	yes	325207	+
6149	scaffold_39	43056	43126	70	19	yes	325207	+
6150	scaffold_39	46848	48072	1224	153	no	NA	NA
6151	scaffold_39	49745	50372	627	71	yes	428025	+
6152	scaffold_39	58104	58681	577	69	yes	211175,325217	-,-
6153	scaffold_39	61160	61239	79	19	no	NA	NA
6154	scaffold_39	63349	63368	19	6	no	NA	NA
6155	scaffold_39	64348	64402	54	12	yes	428027	+
6156	scaffold_39	113783	113904	121	23	no	NA	NA
6157	scaffold_39	126109	127491	1382	129	yes	376101	-
6158	scaffold_39	128447	129426	979	91	yes	428031	+
6159	scaffold_39	133996	134256	260	27	yes	325229	+
6160	scaffold_39	134456	134470	14	4	yes	325229	+
6161	scaffold_39	134558	134865	307	30	no	NA	NA
6162	scaffold_39	135375	135387	12	4	yes	325230	+
6163	scaffold_39	135695	135974	279	25	yes	325230	+
6164	scaffold_39	139425	139510	85	12	no	NA	NA
6165	scaffold_39	166435	168059	1624	191	no	NA	NA
6166	scaffold_39	208343	208615	272	18	yes	428048	+
6167	scaffold_39	223033	223455	422	40	yes	297794	-
6168	scaffold_39	227944	229049	1105	164	yes	114940	+
6169	scaffold_39	242371	243716	1345	161	yes	394645	-
6170	scaffold_39	252164	252466	302	30	yes	376138	+
6171	scaffold_39	266281	266386	105	17	yes	325263	-
6172	scaffold_39	269260	269676	416	56	yes	325264	+
6173	scaffold_39	269822	269893	71	14	yes	325264	+
6174	scaffold_39	276684	277525	841	71	yes	325266	+
6175	scaffold_39	322925	323714	789	69	no	NA	NA
6176	scaffold_39	328863	328868	5	4	no	NA	NA
6177	scaffold_39	329533	330389	856	87	yes	376153	+
6178	scaffold_39	334414	334427	13	4	no	NA	NA
6179	scaffold_39	334532	335556	1024	127	yes	428066	-
6180	scaffold_39	341760	343156	1396	133	yes	415185,415186	-,+
6181	scaffold_39	365552	366248	696	83	yes	325292	-
6182	scaffold_39	370209	371086	877	97	yes	415189	+
6183	scaffold_39	376141	376718	577	65	yes	325295	+
6184	scaffold_39	380360	381006	646	68	yes	325297	-
6185	scaffold_39	382743	383654	911	136	yes	325299	-
6186	scaffold_39	385296	385879	583	68	yes	221327	-
6187	scaffold_39	386533	386557	24	8	yes	376168	+
6188	scaffold_39	387127	387474	347	31	yes	376168	+
6189	scaffold_39	392174	392639	465	46	yes	297823,325310	-,-
6190	scaffold_39	393991	394748	757	100	no	NA	NA
6191	scaffold_39	405853	407489	1636	206	yes	247008	-
6192	scaffold_39	416648	417228	580	49	yes	115733	-
6193	scaffold_39	417663	417670	7	3	yes	115733,376172	-,+
6194	scaffold_39	422983	423030	47	12	no	NA	NA
6195	scaffold_39	469531	470379	848	78	yes	325339	+
6196	scaffold_39	488167	488763	596	53	yes	394682	+
6197	scaffold_39	492962	493170	208	42	yes	376194	-
6198	scaffold_39	493261	493490	229	26	yes	376194	-
6199	scaffold_39	496762	497828	1066	122	no	NA	NA
6200	scaffold_39	502368	503230	862	78	yes	394684	-
6201	scaffold_39	524370	525254	884	122	yes	325349	+
6202	scaffold_39	527349	527357	8	4	no	NA	NA
6203	scaffold_39	527642	528618	976	77	yes	325351	-
6204	scaffold_39	531549	532482	933	96	yes	394689	+
6205	scaffold_39	548774	549797	1023	118	yes	325355	-
6206	scaffold_39	561047	562004	957	133	yes	394691	-
6207	scaffold_39	564165	565355	1190	125	yes	325371	+
6208	scaffold_39	574689	576136	1447	146	yes	394694,415250	+,-
6209	scaffold_39	576246	576252	6	4	yes	415250	-
6210	scaffold_39	589544	590593	1049	88	yes	247033	-
6211	scaffold_39	609082	609102	20	8	yes	428118	-
6212	scaffold_39	659027	659053	26	6	yes	325396	+
6213	scaffold_39	666286	666353	67	20	yes	415262	+
6214	scaffold_39	667081	667262	181	23	no	NA	NA
6215	scaffold_39	668887	669011	124	26	no	NA	NA
6216	scaffold_39	669850	669908	58	18	no	NA	NA
6217	scaffold_39	670770	670829	59	17	yes	297868	+
6218	scaffold_39	671698	671765	67	20	yes	297869	+
6219	scaffold_39	672619	672678	59	18	yes	415266	+
6220	scaffold_39	673527	673586	59	18	no	NA	NA
6221	scaffold_39	674430	674489	59	18	no	NA	NA
6222	scaffold_39	675344	675402	58	18	no	NA	NA
6223	scaffold_39	676244	676312	68	15	yes	415269	+
6224	scaffold_39	681405	681417	12	6	no	NA	NA
6225	scaffold_39	681553	681658	105	25	no	NA	NA
6226	scaffold_39	682370	682461	91	17	no	NA	NA
6227	scaffold_39	682627	682638	11	4	no	NA	NA
6228	scaffold_39	683471	683537	66	18	no	NA	NA
6229	scaffold_39	684483	684543	60	16	no	NA	NA
6230	scaffold_39	685185	685262	77	18	no	NA	NA
6231	scaffold_39	686838	686918	80	20	no	NA	NA
6232	scaffold_39	690701	690738	37	11	yes	415273	+
6233	scaffold_39	691629	691706	77	18	no	NA	NA
6234	scaffold_39	692556	692624	68	18	no	NA	NA
6235	scaffold_39	693491	693567	76	13	no	NA	NA
6236	scaffold_39	694709	694938	229	20	yes	415274	+
6237	scaffold_39	705046	705075	29	6	no	NA	NA
6238	scaffold_39	705194	706467	1273	137	no	NA	NA
6239	scaffold_39	714902	714980	78	20	no	NA	NA
6240	scaffold_39	715899	715966	67	18	no	NA	NA
6241	scaffold_39	716786	716844	58	14	no	NA	NA
6242	scaffold_39	723948	724027	79	16	no	NA	NA
6243	scaffold_39	735563	735632	69	18	no	NA	NA
6244	scaffold_39	743689	743723	34	12	no	NA	NA
6245	scaffold_9	7397	7411	14	6	no	NA	NA
6246	scaffold_9	13086	13154	68	16	no	NA	NA
6247	scaffold_9	28770	28854	84	26	no	NA	NA
6248	scaffold_9	62767	63690	923	90	yes	312279	-
6249	scaffold_9	71550	72738	1188	124	yes	389497	-
6250	scaffold_9	80090	81120	1030	118	yes	389500	-
6251	scaffold_9	82685	83429	744	91	yes	312291	+
6252	scaffold_9	92764	94271	1507	167	yes	291545	-
6253	scaffold_9	109859	111356	1497	112	no	NA	NA
6254	scaffold_9	116246	117693	1447	153	yes	291549	-
6255	scaffold_9	119945	121156	1211	136	yes	404014	+
6256	scaffold_9	123983	125059	1076	107	yes	422854	+
6257	scaffold_9	127431	127927	496	75	no	NA	NA
6258	scaffold_9	128047	128056	9	4	no	NA	NA
6259	scaffold_9	128373	128380	7	4	no	NA	NA
6260	scaffold_9	131281	132374	1093	142	yes	312314	-
6261	scaffold_9	132577	133478	901	110	yes	312314,422856	-,-
6262	scaffold_9	137198	137232	34	3	no	NA	NA
6263	scaffold_9	137355	137515	160	20	no	NA	NA
6264	scaffold_9	149060	150310	1250	170	yes	312319	-
6265	scaffold_9	173618	175000	1382	162	yes	422862	-
6266	scaffold_9	180593	181625	1032	92	no	NA	NA
6267	scaffold_9	191987	192840	853	103	yes	422865	-
6268	scaffold_9	195887	196013	126	11	no	NA	NA
6269	scaffold_9	196386	196420	34	8	no	NA	NA
6270	scaffold_9	197211	198023	812	78	yes	404029	-
6271	scaffold_9	201937	203346	1409	181	yes	422867	+
6272	scaffold_9	203425	203474	49	8	no	NA	NA
6273	scaffold_9	206837	207405	568	76	no	NA	NA
6274	scaffold_9	210170	211411	1241	91	yes	187602	+
6275	scaffold_9	220284	221588	1304	158	yes	312338	+
6276	scaffold_9	221757	221786	29	10	no	NA	NA
6277	scaffold_9	223526	224700	1174	117	yes	187663,389526	+,-
6278	scaffold_9	224975	226105	1130	131	yes	187663,389526	+,-
6279	scaffold_9	230005	231306	1301	118	yes	291573	+
6280	scaffold_9	233150	233682	532	46	yes	229501	+
6281	scaffold_9	233937	234976	1039	142	yes	229501	+
6282	scaffold_9	239548	240944	1396	123	yes	312351	-
6283	scaffold_9	243421	244494	1073	107	yes	187739	+
6284	scaffold_9	247565	248666	1101	143	yes	312356	+
6285	scaffold_9	252365	256085	3720	413	yes	312362	+
6286	scaffold_9	259030	260191	1161	106	yes	404043	+
6287	scaffold_9	277007	278140	1133	133	yes	187836	+
6288	scaffold_9	279787	280990	1203	117	yes	312376	+
6289	scaffold_9	283567	284769	1202	173	yes	312377	-
6290	scaffold_9	285640	287099	1459	152	yes	404049	-
6291	scaffold_9	290060	291207	1147	152	yes	422885	-
6292	scaffold_9	293796	294874	1078	75	yes	312387	-
6293	scaffold_9	302833	302885	52	12	no	NA	NA
6294	scaffold_9	302958	304655	1697	128	no	NA	NA
6295	scaffold_9	310198	311268	1070	110	yes	312394	+
6296	scaffold_9	316117	317292	1175	140	yes	312396	-
6297	scaffold_9	320183	321244	1061	134	no	NA	NA
6298	scaffold_9	323657	324672	1015	95	yes	312402	+
6299	scaffold_9	347600	348965	1365	143	yes	312411,382531	+,+
6300	scaffold_9	349346	350716	1370	128	yes	312411	+
6301	scaffold_9	352094	352176	82	4	no	NA	NA
6302	scaffold_9	355102	356236	1134	139	yes	188146	-
6303	scaffold_9	358038	358287	249	37	no	NA	NA
6304	scaffold_9	360807	361856	1049	116	no	NA	NA
6305	scaffold_9	371393	372979	1586	177	yes	291607	-
6306	scaffold_9	376076	376649	573	56	yes	312424	-
6307	scaffold_9	379421	379844	423	50	yes	291609	-
6308	scaffold_9	381244	382448	1204	137	yes	312427	+
6309	scaffold_9	384472	385657	1185	129	yes	404074	-
6310	scaffold_9	386569	387452	883	135	yes	389564	+
6311	scaffold_9	387632	387664	32	8	no	NA	NA
6312	scaffold_9	396292	397680	1388	140	yes	404076	-
6313	scaffold_9	397951	398852	901	62	yes	312432	+
6314	scaffold_9	407852	408990	1138	97	yes	312436	-
6315	scaffold_9	411164	411999	835	64	yes	188296	-
6316	scaffold_9	412733	414422	1689	237	yes	312443	+
6317	scaffold_9	421886	422465	579	47	yes	312445	+
6318	scaffold_9	426461	427091	630	86	yes	422914	+
6319	scaffold_9	429698	429706	8	4	yes	389572	+
6320	scaffold_9	429920	429925	5	3	yes	389572	+
6321	scaffold_9	436096	436850	754	55	yes	188412	+
6322	scaffold_9	447783	448772	989	129	yes	312453	-
6323	scaffold_9	459611	460743	1132	123	yes	312458,312459	-,+
6324	scaffold_9	461176	464422	3246	326	yes	312458,312459	-,+
6325	scaffold_9	466458	466495	37	4	no	NA	NA
6326	scaffold_9	468483	469804	1321	167	yes	312467,312469,422924	+,+,+
6327	scaffold_9	470080	471282	1202	162	yes	312469	+
6328	scaffold_9	493252	496725	3473	367	yes	312477,312478,312480	+,+,-
6329	scaffold_9	498402	499340	938	91	yes	312483,312486	-,+
6330	scaffold_9	512114	513290	1176	118	yes	389593	-
6331	scaffold_9	513589	513943	354	27	yes	389593	-
6332	scaffold_9	514421	515339	918	73	yes	404108	+
6333	scaffold_9	515503	515510	7	4	no	NA	NA
6334	scaffold_9	517346	518016	670	54	no	NA	NA
6335	scaffold_9	521941	523194	1253	137	yes	312495	+
6336	scaffold_9	524643	524696	53	12	no	NA	NA
6337	scaffold_9	524814	525611	797	74	yes	312496	-
6338	scaffold_9	528553	529888	1335	168	yes	215962	+
6339	scaffold_9	536853	537522	669	58	yes	422940	+
6340	scaffold_9	559757	560109	352	18	yes	312507	+
6341	scaffold_9	565252	566523	1271	146	yes	422942	-
6342	scaffold_9	567308	568658	1350	108	yes	312510	+
6343	scaffold_9	575391	576712	1321	85	yes	312513	+
6344	scaffold_9	582085	583623	1538	161	yes	312517	-
6345	scaffold_9	585604	586568	964	102	yes	312521	-
6346	scaffold_9	588373	588990	617	49	no	NA	NA
6347	scaffold_9	592035	593048	1013	68	yes	312526	+
6348	scaffold_9	596116	597034	918	95	yes	404121	+
6349	scaffold_9	597521	597524	3	3	no	NA	NA
6350	scaffold_9	630779	631881	1102	162	yes	312539	+
6351	scaffold_9	633305	634893	1588	175	yes	312543	+
6352	scaffold_9	637614	639363	1749	145	no	NA	NA
6353	scaffold_9	639794	639953	159	18	no	NA	NA
6354	scaffold_9	640988	642099	1111	111	yes	312549	+
6355	scaffold_9	642347	643392	1045	110	yes	312553	+
6356	scaffold_9	646747	649596	2849	314	yes	312554,312556,389617	+,-,+
6357	scaffold_9	649839	651363	1524	174	yes	312556,389617	-,+
6358	scaffold_9	658555	658574	19	3	no	NA	NA
6359	scaffold_9	665431	666732	1301	135	yes	422963	-
6360	scaffold_9	676088	676984	896	102	yes	312568	-
6361	scaffold_9	684404	685752	1348	139	yes	312569	-
6362	scaffold_9	688220	688623	403	52	yes	312571	-
6363	scaffold_9	698121	699076	955	119	yes	312572	+
6364	scaffold_9	704900	705760	860	42	no	NA	NA
6365	scaffold_9	712438	712543	105	4	yes	312579	-
6366	scaffold_9	712860	713130	270	34	no	NA	NA
6367	scaffold_9	714490	715563	1073	82	no	NA	NA
6368	scaffold_9	727013	728202	1189	168	yes	422972	-
6369	scaffold_9	729134	730127	993	120	yes	422973	+
6370	scaffold_9	730262	730277	15	8	no	NA	NA
6371	scaffold_9	743614	745000	1386	169	no	NA	NA
6372	scaffold_9	751109	752201	1092	111	yes	312598,312599	-,+
6373	scaffold_9	752377	753179	802	72	yes	312598,312599	-,+
6374	scaffold_9	754238	755173	935	119	yes	312605	+
6375	scaffold_9	757408	758654	1246	184	yes	312607	+
6376	scaffold_9	762224	763475	1251	150	yes	216001	-
6377	scaffold_9	765050	766407	1357	179	yes	189337	+
6378	scaffold_9	766558	766574	16	6	no	NA	NA
6379	scaffold_9	770565	771717	1152	120	yes	422981	+
6380	scaffold_9	785893	789463	3570	362	yes	312624,404171	+,-
6381	scaffold_9	790122	791469	1347	135	yes	312629	+
6382	scaffold_9	799834	801233	1399	129	yes	215808,422988	+,-
6383	scaffold_9	801524	802711	1187	132	yes	215808	+
6384	scaffold_9	803616	804638	1022	114	yes	404176	-
6385	scaffold_9	805831	807165	1334	136	no	NA	NA
6386	scaffold_9	818990	820144	1154	134	yes	389651	-
6387	scaffold_9	823241	823264	23	6	no	NA	NA
6388	scaffold_9	823369	824600	1231	157	yes	312650	-
6389	scaffold_9	830597	831997	1400	149	yes	312655	-
6390	scaffold_9	833857	834873	1016	130	yes	189645,312657	+,-
6391	scaffold_9	835159	836317	1158	118	yes	189645,312657	+,-
6392	scaffold_9	844855	844876	21	8	no	NA	NA
6393	scaffold_9	845277	846520	1243	124	yes	404186	-
6394	scaffold_9	851229	851261	32	4	no	NA	NA
6395	scaffold_9	851799	852943	1144	146	yes	312667	+
6396	scaffold_9	854339	855452	1113	120	yes	291725	+
6397	scaffold_9	857929	859012	1083	128	yes	312672	+
6398	scaffold_9	864512	865669	1157	195	yes	215776	-
6399	scaffold_9	870892	872425	1533	151	yes	423003	-
6400	scaffold_9	893718	893722	4	4	no	NA	NA
6401	scaffold_9	893801	894730	929	75	yes	389665	-
6402	scaffold_9	896940	897525	585	59	no	NA	NA
6403	scaffold_9	904886	906465	1579	180	yes	312686,365334	+,-
6404	scaffold_9	906973	906993	20	6	yes	312686	+
6405	scaffold_9	914027	915373	1346	174	yes	312690	+
6406	scaffold_9	915583	916429	846	108	yes	312690	+
6407	scaffold_9	921089	922389	1300	73	yes	291739	-
6408	scaffold_9	931840	932701	861	40	yes	423012	-
6409	scaffold_9	933092	934590	1498	148	yes	312701	-
6410	scaffold_9	938102	939165	1063	160	yes	312703	+
6411	scaffold_9	942506	942703	197	22	yes	312707	-
6412	scaffold_9	949055	950436	1381	138	no	NA	NA
6413	scaffold_9	952335	953827	1492	152	yes	312716	+
6414	scaffold_9	958685	959655	970	121	yes	312718	+
6415	scaffold_9	964187	965667	1480	132	yes	190007,190015	-,-
6416	scaffold_9	972410	973773	1363	162	yes	312720	+
6417	scaffold_9	980004	981772	1768	104	yes	365332	-
6418	scaffold_9	990263	990861	598	65	yes	229663	-
6419	scaffold_9	999394	1000396	1002	53	yes	291756	+
6420	scaffold_9	1002687	1002936	249	44	yes	312735	+
6421	scaffold_9	1004367	1005787	1420	126	yes	312736	+
6422	scaffold_9	1005918	1005926	8	4	no	NA	NA
6423	scaffold_9	1009849	1010842	993	130	yes	312741	-
6424	scaffold_9	1027530	1029131	1601	154	yes	242257	-
6425	scaffold_9	1041301	1042562	1261	143	yes	190159,190162,312767	-,-,+
6426	scaffold_9	1042876	1043641	765	122	yes	190162,312767	-,+
6427	scaffold_9	1048256	1048277	21	4	no	NA	NA
6428	scaffold_9	1048868	1049434	566	44	yes	312769	+
6429	scaffold_9	1049618	1049711	93	14	no	NA	NA
6430	scaffold_9	1052187	1052967	780	91	yes	312773	-
6431	scaffold_9	1053497	1054357	860	100	yes	312773,423034	-,-
6432	scaffold_9	1054846	1056026	1180	88	yes	423034,190230	-,+
6433	scaffold_9	1056523	1057871	1348	112	yes	291770	-
6434	scaffold_9	1060202	1060211	9	4	no	NA	NA
6435	scaffold_9	1060905	1061835	930	124	yes	190247	+
6436	scaffold_9	1086424	1086451	27	8	yes	382661	-
6437	scaffold_9	1088893	1090431	1538	164	yes	312788	+
6438	scaffold_9	1096152	1096918	766	51	yes	291779	-
6439	scaffold_9	1109575	1109942	367	50	no	NA	NA
6440	scaffold_9	1146411	1146465	54	6	yes	291784	+
6441	scaffold_9	1173837	1174593	756	116	yes	312803,423047	+,+
6442	scaffold_9	1174905	1176234	1329	150	yes	312803	+
6443	scaffold_9	1183517	1184751	1234	170	yes	190431,312814	-,+
6444	scaffold_9	1185810	1187308	1498	153	yes	229693	+
6445	scaffold_9	1189979	1191499	1520	156	yes	312816,404254	+,-
6446	scaffold_9	1192161	1193043	882	98	yes	312816	+
6447	scaffold_9	1203959	1205154	1195	152	yes	385149	-
6448	scaffold_9	1207078	1208735	1657	196	yes	242290	+
6449	scaffold_9	1241713	1242809	1096	150	yes	312881	-
6450	scaffold_9	1243388	1244871	1483	196	yes	190680	+
6451	scaffold_9	1248298	1249550	1252	166	yes	312884	+
6452	scaffold_9	1254131	1255646	1515	152	yes	312887	-
6453	scaffold_9	1259622	1261310	1688	187	yes	404270	-
6454	scaffold_9	1261448	1261488	40	6	no	NA	NA
6455	scaffold_9	1267357	1267524	167	19	no	NA	NA
6456	scaffold_9	1272789	1273603	814	64	yes	404273	-
6457	scaffold_9	1284231	1285664	1433	90	yes	215988	+
6458	scaffold_9	1288693	1289603	910	98	yes	312904	-
6459	scaffold_9	1295208	1296293	1085	120	yes	312908	+
6460	scaffold_9	1297609	1298539	930	120	yes	389738	+
6461	scaffold_9	1300916	1302427	1511	152	yes	190820	-
6462	scaffold_9	1303264	1304363	1099	109	yes	312913	+
6463	scaffold_9	1307917	1308759	842	94	yes	312915	-
6464	scaffold_9	1311793	1312177	384	41	yes	389744	-
6465	scaffold_9	1312397	1312424	27	6	yes	389744	-
6466	scaffold_9	1313283	1314708	1425	145	yes	312918	+
6467	scaffold_9	1321303	1322568	1265	150	yes	312923	-
6468	scaffold_9	1327156	1328390	1234	137	yes	312924	-
6469	scaffold_9	1334643	1336224	1581	202	yes	215951	-
6470	scaffold_9	1337690	1338782	1092	110	yes	312932	+
6471	scaffold_9	1343645	1343653	8	4	no	NA	NA
6472	scaffold_9	1343931	1345499	1568	145	yes	404290	-
6473	scaffold_9	1346359	1347518	1159	120	yes	312935	+
6474	scaffold_9	1348956	1350437	1481	150	yes	291839	+
6475	scaffold_9	1367033	1368531	1498	149	yes	312945	-
6476	scaffold_9	1369965	1370916	951	99	yes	312946	+
6477	scaffold_9	1378789	1380009	1220	115	no	NA	NA
6478	scaffold_9	1387552	1387562	10	4	no	NA	NA
6479	scaffold_9	1389713	1391012	1299	130	yes	312951	+
6480	scaffold_9	1398070	1399929	1859	140	no	NA	NA
6481	scaffold_9	1400521	1400687	166	20	no	NA	NA
6482	scaffold_9	1401324	1402591	1267	93	no	NA	NA
6483	scaffold_9	1403195	1403449	254	33	no	NA	NA
6484	scaffold_9	1404063	1404531	468	37	yes	291846	+
6485	scaffold_9	1408311	1409446	1135	91	yes	423091	-
6486	scaffold_9	1411161	1412454	1293	118	yes	423092	-
6487	scaffold_9	1419460	1420932	1472	156	yes	312965	+
6488	scaffold_9	1425104	1425735	631	40	yes	215967	-
6489	scaffold_9	1432603	1433650	1047	117	yes	191225	+
6490	scaffold_9	1433828	1433845	17	4	no	NA	NA
6491	scaffold_9	1436407	1437488	1081	113	yes	312974	+
6492	scaffold_9	1441505	1442488	983	113	yes	389771	-
6493	scaffold_9	1446702	1446709	7	4	yes	191294	-
6494	scaffold_9	1446792	1448027	1235	171	yes	191294	-
6495	scaffold_9	1469854	1470965	1111	121	yes	404319	-
6496	scaffold_9	1471401	1472122	721	51	no	NA	NA
6497	scaffold_9	1476412	1477825	1413	141	yes	191373	-
6498	scaffold_9	1497093	1497690	597	36	yes	191400	-
6499	scaffold_9	1526731	1527805	1074	146	yes	389784	+
6500	scaffold_145	2090	2109	19	7	no	NA	NA
6501	scaffold_145	5285	5304	19	6	no	NA	NA
6502	scaffold_145	37792	37823	31	10	no	NA	NA
6503	scaffold_267	5807	5846	39	12	no	NA	NA
6504	scaffold_267	5943	7100	1157	112	yes	373301	+
6505	scaffold_267	7208	7244	36	7	no	NA	NA
6506	scaffold_40	18100	19024	924	80	yes	325412	+
6507	scaffold_40	24607	25889	1282	158	yes	394713	-
6508	scaffold_40	26795	27476	681	64	yes	121197	+
6509	scaffold_40	29183	31617	2434	246	yes	325419,404669	+,-
6510	scaffold_40	35000	36192	1192	142	yes	404670	-
6511	scaffold_40	36990	38528	1538	145	yes	121277	+
6512	scaffold_40	49881	51172	1291	160	yes	428140	-
6513	scaffold_40	55710	57098	1388	115	yes	297896	+
6514	scaffold_40	82485	83647	1162	126	yes	121407	+
6515	scaffold_40	91211	92089	878	90	yes	325444	+
6516	scaffold_40	111126	112023	897	63	no	NA	NA
6517	scaffold_40	112603	113156	553	64	no	NA	NA
6518	scaffold_40	113746	115307	1561	160	yes	234620	-
6519	scaffold_40	129421	131005	1584	176	yes	325465	+
6520	scaffold_40	140246	141568	1322	120	yes	404692	-
6521	scaffold_40	146573	146587	14	6	no	NA	NA
6522	scaffold_40	146680	146725	45	10	no	NA	NA
6523	scaffold_40	148454	149186	732	49	no	NA	NA
6524	scaffold_40	149730	149777	47	6	no	NA	NA
6525	scaffold_40	150186	150217	31	3	no	NA	NA
6526	scaffold_40	150362	150751	389	19	no	NA	NA
6527	scaffold_40	151063	151356	293	38	no	NA	NA
6528	scaffold_40	151553	152234	681	65	no	NA	NA
6529	scaffold_40	158916	158948	32	8	no	NA	NA
6530	scaffold_40	159053	159668	615	61	yes	297915	-
6531	scaffold_40	191855	193352	1497	185	yes	325487	+
6532	scaffold_40	206428	208187	1759	162	no	NA	NA
6533	scaffold_40	217004	218579	1575	165	yes	325491	-
6534	scaffold_40	218831	220106	1275	150	yes	325491	-
6535	scaffold_40	225644	226744	1100	98	yes	376614	-
6536	scaffold_40	227648	227808	160	10	no	NA	NA
6537	scaffold_40	233493	234741	1248	115	yes	121834,325497	+,+
6538	scaffold_40	235224	235270	46	13	no	NA	NA
6539	scaffold_40	247663	249208	1545	117	yes	297927	-
6540	scaffold_40	262430	263823	1393	121	yes	325504	+
6541	scaffold_40	271828	273353	1525	154	yes	428165	-
6542	scaffold_40	275071	275651	580	64	yes	325510	-
6543	scaffold_40	275889	277142	1253	134	yes	325510,297930	-,+
6544	scaffold_40	286561	286579	18	8	yes	325515	-
6545	scaffold_40	289512	289529	17	4	yes	122016	-
6546	scaffold_40	289656	290209	553	41	yes	122016	-
6547	scaffold_40	293620	293644	24	3	no	NA	NA
6548	scaffold_40	294637	296082	1445	139	yes	325519	+
6549	scaffold_40	296327	296949	622	64	yes	325519	+
6550	scaffold_40	297366	297373	7	4	no	NA	NA
6551	scaffold_40	302068	302074	6	4	no	NA	NA
6552	scaffold_40	319157	319790	633	56	yes	428174	+
6553	scaffold_40	323712	324777	1065	134	no	NA	NA
6554	scaffold_40	324944	324950	6	4	no	NA	NA
6555	scaffold_40	342454	343585	1131	129	no	NA	NA
6556	scaffold_40	351649	352354	705	70	yes	122209	+
6557	scaffold_40	355969	356239	270	31	yes	325557	+
6558	scaffold_40	356273	356397	124	11	yes	325557	+
6559	scaffold_40	360102	360232	130	18	yes	297948	-
6560	scaffold_40	360437	361494	1057	102	yes	297948	-
6561	scaffold_40	362879	362893	14	4	no	NA	NA
6562	scaffold_40	377419	378197	778	108	no	NA	NA
6563	scaffold_40	403289	404612	1323	152	no	NA	NA
6564	scaffold_40	413069	413834	765	76	yes	376642	-
6565	scaffold_40	423650	424563	913	91	yes	234661	+
6566	scaffold_40	427502	427525	23	4	yes	428186	-
6567	scaffold_40	427618	427683	65	10	yes	428186	-
6568	scaffold_40	427781	428021	240	15	yes	428186	-
6569	scaffold_40	435498	436099	601	72	no	NA	NA
6570	scaffold_40	436320	436342	22	5	yes	376654	-
6571	scaffold_40	452777	453587	810	47	yes	325585	+
6572	scaffold_40	466472	468138	1666	167	yes	366082	+
6573	scaffold_40	475845	476946	1101	146	yes	325589	-
6574	scaffold_40	478618	480275	1657	217	yes	221392	+
6575	scaffold_40	502681	503831	1150	128	yes	428200	-
6576	scaffold_40	523131	524225	1094	115	yes	394781	-
6577	scaffold_40	527265	527283	18	8	no	NA	NA
6578	scaffold_40	527436	527503	67	6	no	NA	NA
6579	scaffold_40	527608	527625	17	5	no	NA	NA
6580	scaffold_40	533219	533709	490	62	yes	428203	-
6581	scaffold_40	533802	533845	43	10	yes	428203	-
6582	scaffold_40	540973	542150	1177	102	no	NA	NA
6583	scaffold_40	545069	545609	540	53	yes	376671	+
6584	scaffold_40	547127	547880	753	80	yes	325608	+
6585	scaffold_40	556913	558111	1198	135	yes	404767	-
6586	scaffold_40	559348	560363	1015	117	yes	325613,428209	-,+
6587	scaffold_40	560539	561898	1359	157	yes	325613,428209	-,+
6588	scaffold_40	564073	565155	1082	145	no	NA	NA
6589	scaffold_40	570634	572354	1720	171	yes	325623	-
6590	scaffold_40	574008	575147	1139	159	yes	325626	-
6591	scaffold_40	589129	590524	1395	200	yes	325633	-
6592	scaffold_40	592913	592963	50	8	no	NA	NA
6593	scaffold_40	593065	594269	1204	149	yes	325635	-
6594	scaffold_40	594567	595978	1411	132	yes	325635,325638	-,-
6595	scaffold_40	601037	602496	1459	135	yes	297985	+
6596	scaffold_40	610749	611320	571	75	yes	325641	-
6597	scaffold_40	616680	617396	716	69	yes	325642	+
6598	scaffold_40	622980	623454	474	72	no	NA	NA
6599	scaffold_40	626562	628025	1463	176	yes	247106	-
6600	scaffold_40	649552	650268	716	77	no	NA	NA
6601	scaffold_40	673369	674073	704	80	yes	325657	+
6602	scaffold_40	677162	677782	620	65	yes	325658	+
6603	scaffold_40	677904	677913	9	4	no	NA	NA
6604	scaffold_40	682321	682916	595	61	yes	394810	-
6605	scaffold_40	689539	691113	1574	181	yes	428232	-
6606	scaffold_40	697997	698692	695	44	yes	325665	-
6607	scaffold_40	699797	700857	1060	127	yes	428234	+
6608	scaffold_40	704173	704587	414	36	yes	122796	+
6609	scaffold_40	704792	704833	41	6	no	NA	NA
6610	scaffold_40	708854	710056	1202	71	yes	428236	-
6611	scaffold_40	715974	717186	1212	156	yes	428239	+
6612	scaffold_40	719541	719581	40	6	no	NA	NA
6613	scaffold_40	719655	719752	97	18	no	NA	NA
6614	scaffold_40	732417	732936	519	33	yes	404806	-
6615	scaffold_40	743266	744896	1630	230	yes	325700	+
6616	scaffold_40	751533	752836	1303	142	yes	404809	+
6617	scaffold_142	1853	3178	1325	68	no	NA	NA
6618	scaffold_142	6762	8566	1804	197	yes	432641	-
6619	scaffold_142	11133	13141	2008	157	yes	432642	-
6620	scaffold_142	19335	19461	126	8	yes	336568	-
6621	scaffold_142	19619	19999	380	32	yes	336568	-
6622	scaffold_142	27507	27903	396	26	no	NA	NA
6623	scaffold_142	28646	29739	1093	95	yes	41503	-
6624	scaffold_142	32241	32391	150	18	yes	386317	+
6625	scaffold_142	39556	40710	1154	100	yes	41516	-
6626	scaffold_142	46208	47227	1019	99	yes	432647,432648	-,+
6627	scaffold_142	57551	57765	214	30	no	NA	NA
6628	scaffold_142	57873	57913	40	12	no	NA	NA
6629	scaffold_142	58021	58042	21	7	no	NA	NA
6630	scaffold_186	3105	3124	19	6	no	NA	NA
6631	scaffold_186	10979	11921	942	102	yes	337070	-
6632	scaffold_186	13641	14623	982	113	yes	337071	+
6633	scaffold_357	551	594	43	5	no	NA	NA
6634	scaffold_357	795	967	172	18	no	NA	NA
6635	scaffold_357	1135	1140	5	3	no	NA	NA
6636	scaffold_357	2304	2426	122	3	no	NA	NA
6637	scaffold_357	4657	4883	226	13	yes	399372	-
6638	scaffold_357	4992	5054	62	6	yes	399372	-
6639	scaffold_357	5195	5244	49	4	yes	399372	-
6640	scaffold_357	5839	5943	104	5	no	NA	NA
6641	scaffold_357	6322	6380	58	6	no	NA	NA
6642	scaffold_41	17529	17547	18	7	no	NA	NA
6643	scaffold_41	25336	26145	809	98	yes	428248	+
6644	scaffold_41	26226	26474	248	31	no	NA	NA
6645	scaffold_41	33818	34322	504	32	yes	325752	+
6646	scaffold_41	38731	40394	1663	129	no	NA	NA
6647	scaffold_41	44337	45458	1121	109	yes	123376,234716,412331	-,-,+
6648	scaffold_41	62522	63292	770	53	yes	394827	+
6649	scaffold_41	66881	66914	33	4	yes	325765	+
6650	scaffold_41	67651	68381	730	110	no	NA	NA
6651	scaffold_41	69781	71055	1274	140	yes	428256	+
6652	scaffold_41	77087	78043	956	121	no	NA	NA
6653	scaffold_41	87230	88491	1261	153	yes	325774	-
6654	scaffold_41	88831	89240	409	37	yes	325774	-
6655	scaffold_41	98117	99224	1107	129	yes	221508,428263	-,+
6656	scaffold_41	104488	105783	1295	148	yes	325788	+
6657	scaffold_41	113685	114977	1292	155	yes	412346	-
6658	scaffold_41	119386	120797	1411	131	yes	325794	-
6659	scaffold_41	122752	123662	910	103	yes	325796	+
6660	scaffold_41	126304	127773	1469	154	yes	325799,325800	-,+
6661	scaffold_41	128127	129140	1013	104	yes	325799,325800	-,+
6662	scaffold_41	129718	130924	1206	134	yes	412351	-
6663	scaffold_41	131259	132276	1017	102	yes	412351	-
6664	scaffold_41	140980	142353	1373	147	yes	325805	+
6665	scaffold_41	149871	150791	920	75	yes	325808	-
6666	scaffold_41	154144	155086	942	101	yes	428274	-
6667	scaffold_41	155435	155479	44	8	yes	428274	-
6668	scaffold_41	162421	163917	1496	137	no	NA	NA
6669	scaffold_41	174224	175032	808	101	no	NA	NA
6670	scaffold_41	186580	186634	54	13	no	NA	NA
6671	scaffold_41	186996	187059	63	6	no	NA	NA
6672	scaffold_41	188722	189442	720	77	yes	123810	+
6673	scaffold_41	209580	210457	877	89	yes	325837	-
6674	scaffold_41	212675	213921	1246	92	yes	412371	+
6675	scaffold_41	228667	229868	1201	138	yes	428284	-
6676	scaffold_41	231068	232239	1171	144	yes	325856	+
6677	scaffold_41	236941	238380	1439	96	yes	394854	+
6678	scaffold_41	243682	244922	1240	195	yes	325864	+
6679	scaffold_41	251203	252199	996	92	yes	412380	+
6680	scaffold_41	256473	257170	697	68	yes	325875	+
6681	scaffold_41	263184	264711	1527	57	yes	325877	+
6682	scaffold_41	283884	285846	1962	213	yes	412386	+
6683	scaffold_41	300701	301766	1065	128	no	NA	NA
6684	scaffold_41	311064	312419	1355	174	no	NA	NA
6685	scaffold_41	315333	316336	1003	93	yes	325909	-
6686	scaffold_41	317648	319030	1382	127	no	NA	NA
6687	scaffold_41	319341	320573	1232	117	yes	325914	+
6688	scaffold_41	321604	322891	1287	134	yes	428297	+
6689	scaffold_41	326831	327981	1150	119	yes	325920	+
6690	scaffold_41	329382	330094	712	67	yes	325925	+
6691	scaffold_41	333000	334362	1362	158	yes	325927	+
6692	scaffold_41	338269	339705	1436	141	yes	325931	+
6693	scaffold_41	340698	342172	1474	167	yes	298072	-
6694	scaffold_41	346629	347441	812	80	no	NA	NA
6695	scaffold_41	351670	353445	1775	151	yes	394872	-
6696	scaffold_41	354513	355340	827	88	yes	325944	-
6697	scaffold_41	359881	360878	997	122	yes	325945	-
6698	scaffold_41	362001	363840	1839	153	yes	247172	-
6699	scaffold_41	364335	365351	1016	119	yes	247172,325955	-,+
6700	scaffold_41	368752	370059	1307	113	yes	325957	-
6701	scaffold_41	378820	379580	760	109	no	NA	NA
6702	scaffold_41	399792	399825	33	6	no	NA	NA
6703	scaffold_41	401163	401396	233	26	no	NA	NA
6704	scaffold_41	403244	404044	800	96	yes	428313	-
6705	scaffold_41	407132	407799	667	81	yes	124792	+
6706	scaffold_41	413508	414459	951	89	yes	325978	-
6707	scaffold_41	416474	416485	11	4	no	NA	NA
6708	scaffold_41	417221	418800	1579	200	no	NA	NA
6709	scaffold_41	461365	462259	894	97	no	NA	NA
6710	scaffold_41	463338	463723	385	30	yes	124918	+
6711	scaffold_41	468351	469156	805	46	yes	412438	-
6712	scaffold_41	470415	470577	162	11	no	NA	NA
6713	scaffold_41	472525	473669	1144	80	yes	428325	-
6714	scaffold_41	483450	483455	5	4	yes	428327	+
6715	scaffold_41	490685	491344	659	88	yes	326001	-
6716	scaffold_41	493232	494242	1010	116	yes	326003	-
6717	scaffold_41	495625	495631	6	4	no	NA	NA
6718	scaffold_41	499282	500123	841	76	yes	394896	+
6719	scaffold_41	512077	513202	1125	95	yes	326008	+
6720	scaffold_41	515179	516438	1259	185	yes	326010	-
6721	scaffold_41	519731	520880	1149	100	yes	326014	+
6722	scaffold_41	522887	524243	1356	119	yes	234787	-
6723	scaffold_41	527315	528669	1354	121	yes	412452	-
6724	scaffold_41	529730	530469	739	69	no	NA	NA
6725	scaffold_41	533411	533428	17	6	no	NA	NA
6726	scaffold_41	533530	535059	1529	189	yes	326020	-
6727	scaffold_41	541314	542080	766	53	yes	125183,428338	-,-
6728	scaffold_41	546619	546624	5	4	no	NA	NA
6729	scaffold_41	546951	546975	24	6	yes	326021	-
6730	scaffold_41	547161	548242	1081	105	yes	326021	-
6731	scaffold_41	551360	552144	784	103	yes	326024	-
6732	scaffold_41	552942	554490	1548	193	yes	326025	+
6733	scaffold_41	554711	554726	15	4	no	NA	NA
6734	scaffold_41	559543	560809	1266	128	yes	394907	+
6735	scaffold_41	578262	579720	1458	148	yes	412463	+
6736	scaffold_41	584795	585410	615	76	no	NA	NA
6737	scaffold_41	591098	592171	1073	55	no	NA	NA
6738	scaffold_41	600609	601828	1219	155	no	NA	NA
6739	scaffold_41	606580	607368	788	54	yes	326044	+
6740	scaffold_41	609040	609920	880	92	yes	326045	-
6741	scaffold_41	616834	618650	1816	197	no	NA	NA
6742	scaffold_41	619857	620397	540	58	no	NA	NA
6743	scaffold_41	620531	621341	810	69	yes	326050	-
6744	scaffold_41	621794	624043	2249	182	yes	326050,326054,428352	-,-,-
6745	scaffold_41	627996	628005	9	4	no	NA	NA
6746	scaffold_41	631074	632435	1361	187	no	NA	NA
6747	scaffold_41	634103	634112	9	4	no	NA	NA
6748	scaffold_41	636035	636933	898	66	yes	298133	+
6749	scaffold_41	638704	640127	1423	193	yes	125374	+
6750	scaffold_41	642499	642512	13	4	no	NA	NA
6751	scaffold_41	644641	646257	1616	143	yes	234802	+
6752	scaffold_41	667941	667990	49	6	no	NA	NA
6753	scaffold_41	668094	669379	1285	118	yes	412480	-
6754	scaffold_41	682016	682568	552	54	no	NA	NA
6755	scaffold_41	687103	687886	783	64	yes	326086	+
6756	scaffold_41	692718	693431	713	74	yes	394933	-
6757	scaffold_41	695176	698966	3790	433	yes	326088	-
6758	scaffold_41	708048	709033	985	97	yes	326090	-
6759	scaffold_41	723459	724233	774	72	yes	428374	-
6760	scaffold_41	729553	730166	613	82	no	NA	NA
6761	scaffold_236	3642	3706	64	16	no	NA	NA
6762	scaffold_236	13679	13697	18	8	no	NA	NA
6763	scaffold_236	14173	14191	18	6	no	NA	NA
6764	scaffold_6	12281	13381	1100	116	yes	400846	+
6765	scaffold_6	13647	13653	6	4	yes	400846	+
6766	scaffold_6	15261	16617	1356	133	yes	400847	+
6767	scaffold_6	20534	21849	1315	122	yes	310099	+
6768	scaffold_6	24124	25597	1473	156	yes	310101	-
6769	scaffold_6	27865	28967	1102	71	no	NA	NA
6770	scaffold_6	32212	32422	210	18	yes	153276	-
6771	scaffold_6	49790	51040	1250	120	yes	215105	+
6772	scaffold_6	54056	54146	90	20	no	NA	NA
6773	scaffold_6	71376	72558	1182	102	yes	400860	-
6774	scaffold_6	82904	84235	1331	151	yes	290634	-
6775	scaffold_6	86224	86252	28	8	no	NA	NA
6776	scaffold_6	86382	87299	917	97	yes	310120	-
6777	scaffold_6	87932	89029	1097	113	yes	310123	+
6778	scaffold_6	93411	94375	964	134	yes	153378,310131	-,+
6779	scaffold_6	94657	95549	892	128	yes	153378,310131	-,+
6780	scaffold_6	98909	99718	809	94	yes	228751	+
6781	scaffold_6	108230	109479	1249	128	yes	153498	+
6782	scaffold_6	121568	123118	1550	156	yes	422094	+
6783	scaffold_6	128595	129708	1113	127	yes	310156,310158	-,+
6784	scaffold_6	129877	131419	1542	209	yes	310156,310158	-,+
6785	scaffold_6	136012	136800	788	83	yes	290648	+
6786	scaffold_6	144333	145846	1513	160	yes	400876	-
6787	scaffold_6	169148	170522	1374	188	yes	388754	-
6788	scaffold_6	170709	171947	1238	112	yes	388754	-
6789	scaffold_6	172575	173009	434	45	yes	310179,310180	-,+
6790	scaffold_6	173168	174119	951	124	yes	310179,310180	-,+
6791	scaffold_6	191933	192964	1031	103	yes	310185	-
6792	scaffold_6	195252	195965	713	54	no	NA	NA
6793	scaffold_6	196866	198091	1225	77	no	NA	NA
6794	scaffold_6	207287	208398	1111	113	yes	310189	+
6795	scaffold_6	229102	229121	19	6	yes	310198	-
6796	scaffold_6	229269	230634	1365	140	yes	310198	-
6797	scaffold_6	234117	235101	984	98	yes	400892	+
6798	scaffold_6	242187	243944	1757	180	yes	422113	-
6799	scaffold_6	253011	253611	600	36	yes	290670	-
6800	scaffold_6	256069	257229	1160	129	yes	153864,205279	+,+
6801	scaffold_6	259983	261221	1238	122	yes	310214	-
6802	scaffold_6	266794	267796	1002	89	yes	153907	+
6803	scaffold_6	269064	270570	1506	162	yes	310219	+
6804	scaffold_6	283346	283966	620	36	yes	290679	-
6805	scaffold_6	286751	287830	1079	124	yes	400906	-
6806	scaffold_6	290146	292329	2183	202	yes	310227	+
6807	scaffold_6	292724	293754	1030	79	yes	400909	+
6808	scaffold_6	300689	302104	1415	133	yes	422125	-
6809	scaffold_6	306126	307317	1191	153	yes	310235	-
6810	scaffold_6	311117	312263	1146	108	yes	154010	+
6811	scaffold_6	314031	314944	913	79	yes	310242	-
6812	scaffold_6	315125	316566	1441	169	yes	310242,400915	-,+
6813	scaffold_6	318457	319696	1239	178	yes	310249	+
6814	scaffold_6	332192	333918	1726	218	no	NA	NA
6815	scaffold_6	338799	339042	243	24	yes	154104	+
6816	scaffold_6	378652	379748	1096	108	yes	400926	-
6817	scaffold_6	381615	382973	1358	174	yes	400927	+
6818	scaffold_6	392370	393576	1206	141	yes	310270	-
6819	scaffold_6	400459	401380	921	68	yes	400930	+
6820	scaffold_6	408196	409225	1029	116	no	NA	NA
6821	scaffold_6	410641	412036	1395	163	yes	310277	+
6822	scaffold_6	414124	414942	818	125	yes	310278	-
6823	scaffold_6	417374	418726	1352	156	yes	310280	+
6824	scaffold_6	429074	430678	1604	194	yes	310282	-
6825	scaffold_6	435864	435920	56	10	yes	388806	-
6826	scaffold_6	436067	437024	957	113	yes	310285	-
6827	scaffold_6	440220	441344	1124	87	no	NA	NA
6828	scaffold_6	446292	447425	1133	128	yes	290717	+
6829	scaffold_6	451387	452721	1334	124	yes	310298	+
6830	scaffold_6	457984	459427	1443	120	yes	400943	-
6831	scaffold_6	464651	464699	48	12	yes	290721	-
6832	scaffold_6	466092	467439	1347	139	yes	154459	-
6833	scaffold_6	467688	469004	1316	141	yes	310312	+
6834	scaffold_6	483838	484852	1014	124	yes	422162	+
6835	scaffold_6	493686	494593	907	121	yes	422164,422165	-,+
6836	scaffold_6	494921	496195	1274	140	yes	422164,422165	-,+
6837	scaffold_6	505756	507397	1641	198	yes	422168	+
6838	scaffold_6	521070	522350	1280	154	yes	310336	+
6839	scaffold_6	547991	548932	941	104	yes	310348	-
6840	scaffold_6	551926	553316	1390	190	yes	310351	+
6841	scaffold_6	553460	553481	21	8	no	NA	NA
6842	scaffold_6	558157	558935	778	76	yes	310352	+
6843	scaffold_6	559108	559305	197	10	no	NA	NA
6844	scaffold_6	565164	566889	1725	168	yes	422179	-
6845	scaffold_6	568737	569919	1182	145	yes	310357	+
6846	scaffold_6	580055	581823	1768	180	yes	310360	-
6847	scaffold_6	584436	585585	1149	114	yes	310370	-
6848	scaffold_6	590645	591555	910	137	yes	241449	+
6849	scaffold_6	593643	594773	1130	108	no	NA	NA
6850	scaffold_6	599964	600574	610	45	yes	310376	+
6851	scaffold_6	608715	609247	532	55	yes	310378	+
6852	scaffold_6	614799	616351	1552	176	yes	422189	+
6853	scaffold_6	624515	624541	26	6	no	NA	NA
6854	scaffold_6	624667	625705	1038	109	yes	310380,310384	-,+
6855	scaffold_6	625892	626800	908	103	yes	310380,310384	-,+
6856	scaffold_6	629202	630415	1213	163	yes	310390	+
6857	scaffold_6	631991	632977	986	102	yes	310396	+
6858	scaffold_6	636165	637397	1232	138	yes	310397	+
6859	scaffold_6	639607	640539	932	129	yes	310400	+
6860	scaffold_6	642633	643297	664	84	yes	214915	+
6861	scaffold_6	646406	647659	1253	162	yes	310405	+
6862	scaffold_6	661950	663635	1685	198	yes	310413	+
6863	scaffold_6	668180	669506	1326	166	yes	310415,422201	+,-
6864	scaffold_6	669796	670895	1099	150	yes	310415	+
6865	scaffold_6	674337	675377	1040	88	yes	388862	+
6866	scaffold_6	685521	686932	1411	186	yes	310419	+
6867	scaffold_6	691291	692268	977	117	yes	310424	-
6868	scaffold_6	697495	698666	1171	142	yes	310428	+
6869	scaffold_6	706034	707137	1103	66	yes	400998	-
6870	scaffold_6	707513	708259	746	54	no	NA	NA
6871	scaffold_6	714692	715715	1023	116	yes	310443	-
6872	scaffold_6	719641	719653	12	6	no	NA	NA
6873	scaffold_6	727097	728923	1826	158	yes	155283	+
6874	scaffold_6	739973	739982	9	4	yes	401005	-
6875	scaffold_6	740113	740581	468	20	yes	401005	-
6876	scaffold_6	758120	758329	209	18	yes	422219	-
6877	scaffold_6	767421	767434	13	4	no	NA	NA
6878	scaffold_6	767629	768462	833	118	yes	310457	-
6879	scaffold_6	804380	805368	988	108	yes	241471	+
6880	scaffold_6	807444	808581	1137	134	yes	388883	+
6881	scaffold_6	813429	813472	43	4	yes	290799	+
6882	scaffold_6	819148	820844	1696	90	yes	155419	+
6883	scaffold_6	824072	827590	3518	375	yes	310481,388888	-,+
6884	scaffold_6	834177	835289	1112	158	yes	310486	+
6885	scaffold_6	840215	841497	1282	176	yes	388891	-
6886	scaffold_6	848122	849250	1128	122	yes	310493	+
6887	scaffold_6	853194	853552	358	34	no	NA	NA
6888	scaffold_6	856527	857315	788	74	yes	155527,310498	-,+
6889	scaffold_6	857838	859074	1236	156	yes	310498	+
6890	scaffold_6	864092	864897	805	116	yes	310503,310506	-,+
6891	scaffold_6	865108	866293	1185	165	yes	310503,310506	-,+
6892	scaffold_6	866414	866420	6	4	no	NA	NA
6893	scaffold_6	867782	870469	2687	253	yes	310507,310509	+,+
6894	scaffold_6	875233	876500	1267	124	yes	310510	-
6895	scaffold_6	891930	893387	1457	133	yes	155678	+
6896	scaffold_6	901831	902750	919	87	yes	422248	+
6897	scaffold_6	943099	943144	45	8	yes	422256	+
6898	scaffold_6	943277	943769	492	51	yes	422256	+
6899	scaffold_6	949032	949113	81	15	yes	155760	+
6900	scaffold_6	951195	952141	946	114	no	NA	NA
6901	scaffold_6	972367	972613	246	25	no	NA	NA
6902	scaffold_6	972667	972951	284	33	no	NA	NA
6903	scaffold_6	975132	975623	491	39	yes	310580	+
6904	scaffold_6	982713	982771	58	6	no	NA	NA
6905	scaffold_6	983373	984277	904	53	yes	215160	+
6906	scaffold_6	995494	996860	1366	161	yes	422268	-
6907	scaffold_6	1002448	1002530	82	7	yes	155857	-
6908	scaffold_6	1013242	1014922	1680	205	no	NA	NA
6909	scaffold_6	1041871	1042640	769	50	no	NA	NA
6910	scaffold_6	1051968	1052942	974	118	yes	385011	-
6911	scaffold_6	1057617	1057629	12	4	no	NA	NA
6912	scaffold_6	1057797	1058780	983	123	yes	310607	-
6913	scaffold_6	1059108	1060454	1346	178	yes	310607,290855	-,+
6914	scaffold_6	1069432	1070514	1082	115	yes	310611	-
6915	scaffold_6	1070900	1071831	931	96	yes	310611	-
6916	scaffold_6	1074874	1076315	1441	136	no	NA	NA
6917	scaffold_6	1076879	1078079	1200	156	no	NA	NA
6918	scaffold_6	1085878	1087007	1129	77	no	NA	NA
6919	scaffold_6	1096458	1097604	1146	140	yes	388941	-
6920	scaffold_6	1106968	1107589	621	46	yes	155984	-
6921	scaffold_6	1107838	1107865	27	8	yes	155984	-
6922	scaffold_6	1161267	1162600	1333	128	yes	310671	-
6923	scaffold_6	1165212	1165448	236	16	no	NA	NA
6924	scaffold_6	1174746	1176135	1389	111	yes	379770	+
6925	scaffold_6	1179416	1180557	1141	118	yes	156138,310692	+,-
6926	scaffold_6	1181078	1182058	980	93	yes	156138,310692	+,-
6927	scaffold_6	1185465	1186588	1123	136	yes	310697	+
6928	scaffold_6	1190795	1192295	1500	168	yes	215057	+
6929	scaffold_6	1206779	1207746	967	99	yes	310704,310705	-,+
6930	scaffold_6	1208004	1209104	1100	104	yes	310704,310705	-,+
6931	scaffold_6	1214705	1215643	938	59	yes	310707	-
6932	scaffold_6	1217695	1217784	89	10	no	NA	NA
6933	scaffold_6	1217940	1218533	593	90	yes	156262	-
6934	scaffold_6	1218796	1218824	28	10	yes	156262	-
6935	scaffold_6	1225076	1226154	1078	83	yes	310714	-
6936	scaffold_6	1234799	1235771	972	101	yes	310717	-
6937	scaffold_6	1237810	1238744	934	110	yes	310719	+
6938	scaffold_6	1254272	1255634	1362	131	yes	228939	-
6939	scaffold_6	1256738	1258386	1648	257	yes	422309	+
6940	scaffold_6	1265181	1266322	1141	144	yes	310726	+
6941	scaffold_6	1278092	1279749	1657	171	yes	156364	-
6942	scaffold_6	1286663	1287898	1235	147	yes	401127	-
6943	scaffold_6	1288957	1290464	1507	196	no	NA	NA
6944	scaffold_6	1297390	1298297	907	105	yes	156417	+
6945	scaffold_6	1300951	1305048	4097	473	yes	310738	+
6946	scaffold_6	1305444	1306550	1106	136	no	NA	NA
6947	scaffold_6	1315692	1316985	1293	162	no	NA	NA
6948	scaffold_6	1319085	1320261	1176	108	yes	228960	+
6949	scaffold_6	1326841	1328439	1598	157	yes	422318	-
6950	scaffold_6	1330288	1332780	2492	281	no	NA	NA
6951	scaffold_6	1339772	1340818	1046	80	yes	156511	+
6952	scaffold_6	1346932	1348266	1334	132	yes	290907	+
6953	scaffold_6	1352912	1354267	1355	146	yes	388977	+
6954	scaffold_6	1358929	1359818	889	131	yes	310759	-
6955	scaffold_6	1366428	1367616	1188	129	yes	388981	-
6956	scaffold_6	1368724	1369744	1020	123	yes	310767	-
6957	scaffold_6	1377026	1378010	984	107	yes	310770	+
6958	scaffold_6	1382432	1382443	11	6	no	NA	NA
6959	scaffold_6	1383998	1384835	837	110	no	NA	NA
6960	scaffold_6	1388613	1389398	785	75	yes	310775	-
6961	scaffold_6	1397083	1398159	1076	136	yes	310777	-
6962	scaffold_6	1401549	1403151	1602	121	no	NA	NA
6963	scaffold_6	1409087	1410452	1365	143	yes	310779	-
6964	scaffold_6	1410997	1412168	1171	166	yes	401154	+
6965	scaffold_6	1417635	1418788	1153	142	yes	310788	-
6966	scaffold_6	1419666	1420220	554	86	yes	388990	+
6967	scaffold_6	1422262	1423564	1302	118	yes	310791	+
6968	scaffold_6	1429669	1430841	1172	91	yes	310793	-
6969	scaffold_6	1433539	1434402	863	88	yes	310798	-
6970	scaffold_6	1435509	1436627	1118	110	yes	310801	+
6971	scaffold_6	1440330	1441617	1287	121	yes	310806	-
6972	scaffold_6	1442493	1444215	1722	166	yes	422341	+
6973	scaffold_6	1444303	1445121	818	88	yes	310808,310810	-,+
6974	scaffold_6	1445397	1446997	1600	171	yes	310808,310810	-,+
6975	scaffold_6	1448582	1449756	1174	127	yes	422344	-
6976	scaffold_6	1451370	1452353	983	133	yes	422345	+
6977	scaffold_6	1456724	1457840	1116	87	yes	310815	+
6978	scaffold_6	1461440	1462161	721	65	yes	310818	+
6979	scaffold_6	1467460	1468731	1271	126	yes	422347	-
6980	scaffold_6	1470027	1470984	957	122	yes	310820	+
6981	scaffold_6	1472215	1473433	1218	133	yes	156920,290938	+,+
6982	scaffold_6	1474777	1475847	1070	112	yes	310826,310828	-,+
6983	scaffold_6	1476261	1477316	1055	97	yes	310826,310828	-,+
6984	scaffold_6	1478877	1479841	964	74	yes	310833	-
6985	scaffold_6	1483578	1485010	1432	214	yes	310834,389009	+,-
6986	scaffold_6	1493407	1494606	1199	142	yes	310838,310839	-,+
6987	scaffold_6	1498871	1500085	1214	118	yes	389016	-
6988	scaffold_6	1502891	1502953	62	6	no	NA	NA
6989	scaffold_6	1503049	1503377	328	42	yes	310842	-
6990	scaffold_6	1513388	1516023	2635	268	yes	310850,310851	+,-
6991	scaffold_6	1516948	1521908	4960	444	no	NA	NA
6992	scaffold_6	1523530	1525054	1524	145	yes	310853	+
6993	scaffold_6	1535799	1536910	1111	101	yes	401188	+
6994	scaffold_6	1542183	1543240	1057	128	yes	422366	-
6995	scaffold_6	1545216	1546332	1116	115	yes	310863,401191	-,+
6996	scaffold_6	1552241	1553268	1027	113	yes	422369	-
6997	scaffold_6	1595010	1596586	1576	191	yes	310898	+
6998	scaffold_6	1601526	1601534	8	4	no	NA	NA
6999	scaffold_6	1611686	1612656	970	71	yes	310910	-
7000	scaffold_140	18630	19694	1064	135	yes	336537	-
7001	scaffold_140	39330	39521	191	9	yes	432630	-
7002	scaffold_140	43076	44088	1012	112	no	NA	NA
7003	scaffold_140	45585	46604	1019	105	no	NA	NA
7004	scaffold_140	51255	51274	19	7	no	NA	NA
7005	scaffold_171	27208	27347	139	9	no	NA	NA
7006	scaffold_171	27477	27846	369	16	no	NA	NA
7007	scaffold_171	27945	28120	175	7	no	NA	NA
7008	scaffold_219	17847	17866	19	7	no	NA	NA
7009	scaffold_275	7167	7206	39	12	no	NA	NA
7010	scaffold_275	10318	10369	51	10	no	NA	NA
7011	scaffold_275	10839	10857	18	6	no	NA	NA
7012	scaffold_42	29637	30777	1140	115	yes	326134	+
7013	scaffold_42	38061	39065	1004	120	yes	326137	+
7014	scaffold_42	39141	39547	406	42	no	NA	NA
7015	scaffold_42	47888	47909	21	6	no	NA	NA
7016	scaffold_42	51822	52054	232	10	yes	326145	+
7017	scaffold_42	56458	56489	31	12	yes	403808	+
7018	scaffold_42	56614	56638	24	8	yes	403808	+
7019	scaffold_42	89030	90351	1321	151	yes	326149	-
7020	scaffold_42	116454	117462	1008	123	yes	326152	-
7021	scaffold_42	133126	134155	1029	117	no	NA	NA
7022	scaffold_42	134875	134889	14	6	no	NA	NA
7023	scaffold_42	171503	171851	348	26	yes	326163	+
7024	scaffold_42	172845	172953	108	31	no	NA	NA
7025	scaffold_42	175282	176019	737	82	yes	394967	+
7026	scaffold_42	176125	176178	53	16	no	NA	NA
7027	scaffold_42	183383	184965	1582	202	yes	125783	-
7028	scaffold_42	227971	228786	815	107	yes	428414	-
7029	scaffold_42	247455	248406	951	124	no	NA	NA
7030	scaffold_42	404253	405412	1159	138	no	NA	NA
7031	scaffold_42	406774	407692	918	114	yes	298227,326199	+,+
7032	scaffold_42	420552	420592	40	12	no	NA	NA
7033	scaffold_42	436784	437789	1005	104	yes	428435	+
7034	scaffold_42	462157	462997	840	129	yes	403902	-
7035	scaffold_42	469990	470537	547	66	yes	326217	-
7036	scaffold_42	471687	472840	1153	122	no	NA	NA
7037	scaffold_42	485102	486005	903	122	yes	395001	+
7038	scaffold_42	486106	486121	15	6	no	NA	NA
7039	scaffold_42	501344	502473	1129	97	yes	126209	-
7040	scaffold_42	507973	508859	886	112	yes	428447	-
7041	scaffold_42	615902	615969	67	16	no	NA	NA
7042	scaffold_42	617057	617124	67	18	no	NA	NA
7043	scaffold_42	618017	618076	59	16	no	NA	NA
7044	scaffold_42	639267	639335	68	15	no	NA	NA
7045	scaffold_42	640548	640608	60	16	no	NA	NA
7046	scaffold_42	641609	641669	60	16	no	NA	NA
7047	scaffold_42	642686	642707	21	8	no	NA	NA
7048	scaffold_42	643622	643675	53	9	no	NA	NA
7049	scaffold_42	644535	644556	21	8	no	NA	NA
7050	scaffold_42	645256	645271	15	8	yes	298270	+
7051	scaffold_42	652929	652937	8	4	no	NA	NA
7052	scaffold_42	660180	660198	18	6	no	NA	NA
7053	scaffold_42	685449	686496	1047	127	no	NA	NA
7054	scaffold_42	694091	694126	35	8	no	NA	NA
7055	scaffold_42	694679	694733	54	6	yes	395018	-
7056	scaffold_42	694895	695226	331	12	yes	395018	-
7057	scaffold_218	3162	3187	25	8	no	NA	NA
7058	scaffold_218	3656	3674	18	5	no	NA	NA
7059	scaffold_43	7810	8893	1083	85	yes	126595	-
7060	scaffold_43	25579	26664	1085	116	yes	428469	-
7061	scaffold_43	41974	43319	1345	128	yes	395030	+
7062	scaffold_43	43455	44732	1277	148	yes	326283	-
7063	scaffold_43	45986	46939	953	124	no	NA	NA
7064	scaffold_43	49858	50244	386	31	no	NA	NA
7065	scaffold_43	50949	52354	1405	172	no	NA	NA
7066	scaffold_43	58878	59935	1057	110	yes	326290	+
7067	scaffold_43	64366	65847	1481	141	yes	377061	+
7068	scaffold_43	70404	71225	821	98	no	NA	NA
7069	scaffold_43	72490	73223	733	102	no	NA	NA
7070	scaffold_43	78951	80036	1085	150	no	NA	NA
7071	scaffold_43	80333	80349	16	4	no	NA	NA
7072	scaffold_43	82375	83369	994	119	yes	326306	-
7073	scaffold_43	84609	85929	1320	154	no	NA	NA
7074	scaffold_43	93842	94974	1132	121	yes	247299	-
7075	scaffold_43	98624	100052	1428	140	yes	395041	-
7076	scaffold_43	100583	101588	1005	119	yes	395041,419079	-,+
7077	scaffold_43	105016	106504	1488	179	yes	419080	-
7078	scaffold_43	112053	113646	1593	205	yes	126973	-
7079	scaffold_43	126125	126876	751	84	yes	326327	-
7080	scaffold_43	127505	129027	1522	175	yes	326330	+
7081	scaffold_43	133659	134784	1125	85	yes	234892	-
7082	scaffold_43	136777	137702	925	150	yes	221689	-
7083	scaffold_43	172741	174333	1592	142	yes	298324	+
7084	scaffold_43	177605	178628	1023	105	yes	326344	+
7085	scaffold_43	183817	185311	1494	122	yes	298326	-
7086	scaffold_43	186710	188157	1447	161	yes	298327	+
7087	scaffold_43	191150	191162	12	4	yes	221701	-
7088	scaffold_43	191474	191772	298	43	yes	221701	-
7089	scaffold_43	192647	193632	985	136	yes	428498	+
7090	scaffold_43	193779	193812	33	6	no	NA	NA
7091	scaffold_43	198207	198837	630	71	yes	326357	-
7092	scaffold_43	203318	204598	1280	103	yes	419099	+
7093	scaffold_43	211033	212085	1052	122	yes	419100	-
7094	scaffold_43	215517	217016	1499	129	yes	326369	-
7095	scaffold_43	224085	225869	1784	168	yes	419102	-
7096	scaffold_43	228470	228486	16	4	no	NA	NA
7097	scaffold_43	228593	229880	1287	129	yes	395061	-
7098	scaffold_43	232406	233162	756	83	yes	326374	-
7099	scaffold_43	237350	238651	1301	138	yes	326378,326381	-,+
7100	scaffold_43	238989	240181	1192	134	yes	326381,326385	+,+
7101	scaffold_43	240684	241637	953	120	yes	326385,127432	+,+
7102	scaffold_43	242077	243199	1122	133	yes	127432	+
7103	scaffold_43	246311	247466	1155	140	yes	395069	+
7104	scaffold_43	255656	255685	29	6	yes	419111	+
7105	scaffold_43	260380	261772	1392	122	yes	395071	+
7106	scaffold_43	261854	261894	40	6	no	NA	NA
7107	scaffold_43	271270	271289	19	4	yes	326396	+
7108	scaffold_43	271632	272618	986	120	yes	326396	+
7109	scaffold_43	281665	282862	1197	150	yes	326399	-
7110	scaffold_43	283344	283500	156	24	yes	326399	-
7111	scaffold_43	290167	290202	35	10	no	NA	NA
7112	scaffold_43	297406	298332	926	81	yes	326407	+
7113	scaffold_43	304573	306994	2421	279	yes	428518	-
7114	scaffold_43	310436	311813	1377	165	yes	326416	-
7115	scaffold_43	315535	316161	626	27	yes	428520	-
7116	scaffold_43	341322	341337	15	8	no	NA	NA
7117	scaffold_43	341539	342452	913	102	no	NA	NA
7118	scaffold_43	344385	345464	1079	132	yes	326425	-
7119	scaffold_43	350726	351699	973	124	yes	326427	-
7120	scaffold_43	353384	354651	1267	149	yes	419126	+
7121	scaffold_43	360514	361759	1245	149	no	NA	NA
7122	scaffold_43	365423	366372	949	79	yes	326436	-
7123	scaffold_43	398646	400107	1461	127	yes	326440	+
7124	scaffold_43	404295	405459	1164	122	yes	326442	+
7125	scaffold_43	412796	414144	1348	175	yes	395093	-
7126	scaffold_43	421872	423260	1388	156	yes	221731	-
7127	scaffold_43	425449	426415	966	139	yes	326452	-
7128	scaffold_43	433306	433334	28	6	no	NA	NA
7129	scaffold_43	460183	461535	1352	122	yes	326488	+
7130	scaffold_43	468145	469122	977	78	yes	419154	-
7131	scaffold_43	475380	475396	16	3	no	NA	NA
7132	scaffold_43	475557	475991	434	33	yes	326494	-
7133	scaffold_43	478026	478086	60	12	yes	428540	+
7134	scaffold_43	478186	479377	1191	136	yes	428540,395104,419158	+,+,-
7135	scaffold_43	479813	480956	1143	129	yes	395104,419158,419160	+,-,-
7136	scaffold_43	486558	487365	807	71	yes	395106	-
7137	scaffold_43	494861	495749	888	52	yes	419165	-
7138	scaffold_43	512075	512086	11	4	no	NA	NA
7139	scaffold_43	519119	520152	1033	125	yes	395108	-
7140	scaffold_43	522145	523123	978	132	no	NA	NA
7141	scaffold_43	528719	530045	1326	176	yes	428551	+
7142	scaffold_43	535955	536803	848	96	no	NA	NA
7143	scaffold_43	537990	538842	852	84	no	NA	NA
7144	scaffold_43	540820	542188	1368	136	yes	326520	+
7145	scaffold_43	548581	549945	1364	192	yes	326523	-
7146	scaffold_43	551597	552537	940	78	yes	428554	+
7147	scaffold_43	560989	562094	1105	147	yes	326529,428557	+,-
7148	scaffold_43	568727	569256	529	18	no	NA	NA
7149	scaffold_43	569771	570841	1070	127	yes	395117	+
7150	scaffold_43	573280	574911	1631	146	yes	419179	+
7151	scaffold_43	578225	578237	12	3	no	NA	NA
7152	scaffold_43	578380	579334	954	126	yes	326536	-
7153	scaffold_43	590452	590463	11	4	no	NA	NA
7154	scaffold_43	590868	591425	557	47	yes	326542	-
7155	scaffold_43	595837	596508	671	76	no	NA	NA
7156	scaffold_43	596680	596688	8	4	no	NA	NA
7157	scaffold_43	602461	603662	1201	103	yes	419185	-
7158	scaffold_43	609871	610882	1011	113	yes	298404	-
7159	scaffold_43	617964	618972	1008	117	yes	326551	-
7160	scaffold_43	621020	622139	1119	145	yes	326552	+
7161	scaffold_43	623874	624814	940	114	yes	326553	-
7162	scaffold_43	626291	627718	1427	163	yes	298407	-
7163	scaffold_43	629157	629814	657	82	yes	326556	-
7164	scaffold_43	636608	638013	1405	144	yes	419192	-
7165	scaffold_43	638538	639405	867	102	yes	326559	+
7166	scaffold_43	646618	647985	1367	178	yes	247384	-
7167	scaffold_43	648750	648773	23	6	no	NA	NA
7168	scaffold_43	654100	655387	1287	127	yes	221657	-
7169	scaffold_43	663208	664614	1406	137	yes	326574	-
7170	scaffold_43	665564	666696	1132	122	yes	326577	-
7171	scaffold_43	672946	674015	1069	110	yes	395140	-
7172	scaffold_43	674857	676227	1370	131	yes	326582	+
7173	scaffold_43	680752	681900	1148	147	yes	428585	-
7174	scaffold_43	682135	683848	1713	180	yes	428585,128524	-,+
7175	scaffold_43	689419	689442	23	6	yes	326589	-
7176	scaffold_43	689551	689840	289	33	yes	326589	-
7177	scaffold_43	690298	690684	386	44	yes	326589	-
7178	scaffold_43	695474	696680	1206	164	no	NA	NA
7179	scaffold_43	704614	706268	1654	133	yes	419208	-
7180	scaffold_43	708704	709918	1214	180	no	NA	NA
7181	scaffold_158	4829	5501	672	40	yes	336765	+
7182	scaffold_158	6017	6935	918	113	yes	336765,336762	+,-
7183	scaffold_158	17109	17547	438	29	no	NA	NA
7184	scaffold_158	17845	18256	411	50	no	NA	NA
7185	scaffold_158	19588	19654	66	13	yes	336776,336777	-,+
7186	scaffold_158	20163	20293	130	5	yes	336776,336777	-,+
7187	scaffold_207	5473	6217	744	78	no	NA	NA
7188	scaffold_44	14231	14827	596	86	yes	326599	+
7189	scaffold_44	32275	32281	6	3	no	NA	NA
7190	scaffold_44	34662	36122	1460	152	yes	414706	-
7191	scaffold_44	39856	41218	1362	92	yes	298435	-
7192	scaffold_44	61425	62481	1056	82	no	NA	NA
7193	scaffold_44	74361	74966	605	84	yes	326629	-
7194	scaffold_44	79945	80951	1006	106	no	NA	NA
7195	scaffold_44	91192	92360	1168	71	yes	326632	+
7196	scaffold_44	106584	107323	739	31	yes	326637	+
7197	scaffold_44	119812	119823	11	3	no	NA	NA
7198	scaffold_44	120080	120687	607	76	no	NA	NA
7199	scaffold_44	126101	126538	437	40	yes	326657	+
7200	scaffold_44	132946	133545	599	34	yes	235024,326660	+,+
7201	scaffold_44	133681	133778	97	25	yes	326660	+
7202	scaffold_44	137969	138803	834	81	yes	326664	-
7203	scaffold_44	138909	139187	278	27	yes	326664	-
7204	scaffold_44	144426	145818	1392	92	yes	326669	-
7205	scaffold_44	158225	159219	994	105	yes	326672	-
7206	scaffold_44	165852	167251	1399	119	yes	428616	-
7207	scaffold_44	183501	184848	1347	141	yes	326676	-
7208	scaffold_44	185824	187244	1420	174	yes	326677	-
7209	scaffold_44	192537	193317	780	84	yes	428621	-
7210	scaffold_44	194117	194489	372	54	yes	247452	+
7211	scaffold_44	199366	199373	7	4	no	NA	NA
7212	scaffold_44	199802	200816	1014	124	yes	221917	-
7213	scaffold_44	206067	206890	823	75	yes	129123	-
7214	scaffold_44	207946	209226	1280	156	yes	326688	+
7215	scaffold_44	213557	214595	1038	66	yes	298470,326690	-,+
7216	scaffold_44	216852	217690	838	82	no	NA	NA
7217	scaffold_44	229745	230579	834	88	yes	326693	+
7218	scaffold_44	232955	232968	13	4	no	NA	NA
7219	scaffold_44	233059	234190	1131	111	yes	326701	-
7220	scaffold_44	236387	237294	907	109	yes	326707	+
7221	scaffold_44	241170	242120	950	94	yes	428632	+
7222	scaffold_44	244592	246166	1574	201	no	NA	NA
7223	scaffold_44	253734	256195	2461	309	yes	326722	-
7224	scaffold_44	260575	260624	49	8	no	NA	NA
7225	scaffold_44	260887	260960	73	18	no	NA	NA
7226	scaffold_44	261122	262511	1389	202	yes	326727	-
7227	scaffold_44	269100	269984	884	89	yes	129419	-
7228	scaffold_44	270496	271369	873	72	no	NA	NA
7229	scaffold_44	273828	274783	955	110	yes	326740	+
7230	scaffold_44	274869	275094	225	22	no	NA	NA
7231	scaffold_44	276794	278037	1243	115	no	NA	NA
7232	scaffold_44	280250	281258	1008	112	yes	326744	-
7233	scaffold_44	284998	285732	734	32	yes	414761	-
7234	scaffold_44	291793	293146	1353	102	yes	326750	+
7235	scaffold_44	298416	299705	1289	144	yes	326751	+
7236	scaffold_44	301877	302889	1012	108	yes	235065	-
7237	scaffold_44	312699	313440	741	50	yes	326774	-
7238	scaffold_44	323236	324618	1382	176	yes	298494	+
7239	scaffold_44	328016	328880	864	94	yes	326785	-
7240	scaffold_44	329546	330716	1170	139	yes	326786	+
7241	scaffold_44	336602	337572	970	125	yes	326789	-
7242	scaffold_44	344722	344735	13	3	no	NA	NA
7243	scaffold_44	344847	345000	153	21	yes	326794	+
7244	scaffold_44	345418	346617	1199	143	yes	326794	+
7245	scaffold_44	356638	356694	56	4	yes	247491	+
7246	scaffold_44	364449	365088	639	81	yes	326802	+
7247	scaffold_44	396883	396908	25	4	no	NA	NA
7248	scaffold_44	399549	401056	1507	166	yes	414786	+
7249	scaffold_44	406274	407769	1495	158	yes	326814	-
7250	scaffold_44	411589	412795	1206	153	yes	129698,428661	+,-
7251	scaffold_44	420484	421146	662	63	yes	414792	+
7252	scaffold_44	426311	426548	237	24	yes	395229	-
7253	scaffold_44	426663	426706	43	10	yes	395229	-
7254	scaffold_44	428532	428741	209	20	no	NA	NA
7255	scaffold_44	431939	432364	425	65	yes	326822	+
7256	scaffold_44	435404	435810	406	45	yes	395231	+
7257	scaffold_44	440528	441142	614	68	yes	326824	-
7258	scaffold_44	454396	455619	1223	117	yes	326835	-
7259	scaffold_44	456069	457324	1255	183	yes	326835	-
7260	scaffold_44	461446	462373	927	125	yes	326840	-
7261	scaffold_44	462968	464271	1303	143	yes	326840,326842	-,+
7262	scaffold_44	466548	467509	961	140	yes	221889	+
7263	scaffold_44	469942	471126	1184	107	yes	395239	+
7264	scaffold_44	476159	477521	1362	120	yes	298530	-
7265	scaffold_44	479973	481213	1240	156	yes	326851	+
7266	scaffold_44	494542	494733	191	10	no	NA	NA
7267	scaffold_44	498053	498831	778	88	yes	326856	-
7268	scaffold_44	501935	503037	1102	117	yes	326858	-
7269	scaffold_44	542545	542582	37	14	yes	414818	+
7270	scaffold_44	542703	542734	31	8	yes	414818	+
7271	scaffold_44	577215	577972	757	116	yes	130174,130178,377263	+,+,-
7272	scaffold_44	590964	591039	75	8	yes	326881	-
7273	scaffold_44	591131	591933	802	95	yes	326881	-
7274	scaffold_44	593808	594851	1043	109	yes	326882	+
7275	scaffold_44	598609	598649	40	4	no	NA	NA
7276	scaffold_44	598779	599260	481	21	yes	428699	-
7277	scaffold_44	599347	599413	66	10	yes	428699	-
7278	scaffold_44	607531	607539	8	3	yes	326888	-
7279	scaffold_44	608877	609430	553	68	yes	130272	+
7280	scaffold_44	610751	612417	1666	208	no	NA	NA
7281	scaffold_44	619100	619141	41	12	yes	326893	+
7282	scaffold_44	622429	623000	571	46	yes	395269	+
7283	scaffold_44	628120	629386	1266	159	yes	326896	+
7284	scaffold_44	634113	635176	1063	126	yes	298568	-
7285	scaffold_44	635441	636757	1316	176	yes	414851	+
7286	scaffold_44	640306	640322	16	6	no	NA	NA
7287	scaffold_44	643410	644179	769	68	no	NA	NA
7288	scaffold_44	659561	660544	983	93	yes	235146	+
7289	scaffold_44	663651	665128	1477	185	yes	385880	+
7290	scaffold_44	677531	678311	780	81	yes	326926	-
7291	scaffold_44	680566	681557	991	121	yes	326930	+
7292	scaffold_44	683861	684630	769	97	yes	298581,414864	-,-
7293	scaffold_44	689894	690728	834	71	yes	326940	-
7294	scaffold_44	693778	694948	1170	105	yes	326941	-
7295	scaffold_135	21682	22774	1092	78	yes	336451	+
7296	scaffold_135	30134	31622	1488	172	yes	432587	+
7297	scaffold_155	28569	28587	18	8	no	NA	NA
7298	scaffold_155	29065	29084	19	7	no	NA	NA
7299	scaffold_133	7692	7707	15	4	no	NA	NA
7300	scaffold_133	26131	26200	69	24	no	NA	NA
7301	scaffold_133	26793	26830	37	10	no	NA	NA
7302	scaffold_133	27021	27089	68	14	no	NA	NA
7303	scaffold_133	27196	27244	48	10	no	NA	NA
7304	scaffold_133	27930	28190	260	29	no	NA	NA
7305	scaffold_133	40267	40581	314	24	no	NA	NA
7306	scaffold_133	41026	41607	581	44	no	NA	NA
7307	scaffold_133	43361	43369	8	4	no	NA	NA
7308	scaffold_133	46502	47202	700	77	no	NA	NA
7309	scaffold_133	48586	48604	18	6	no	NA	NA
7310	scaffold_197	253	272	19	6	no	NA	NA
7311	scaffold_197	21661	21679	18	5	no	NA	NA
7312	scaffold_318	2903	2942	39	12	no	NA	NA
7313	scaffold_318	6049	6096	47	10	no	NA	NA
7314	scaffold_318	6574	6592	18	6	no	NA	NA
7315	scaffold_45	6811	7940	1129	111	yes	413991	+
7316	scaffold_45	28742	29968	1226	105	no	NA	NA
7317	scaffold_45	30537	30595	58	11	no	NA	NA
7318	scaffold_45	45953	47211	1258	140	yes	414001	+
7319	scaffold_45	59465	60500	1035	117	yes	298596	-
7320	scaffold_45	62646	63550	904	99	yes	327012	+
7321	scaffold_45	69564	70863	1299	144	yes	327016	-
7322	scaffold_45	71968	73056	1088	138	no	NA	NA
7323	scaffold_45	73302	73361	59	6	no	NA	NA
7324	scaffold_45	79199	80150	951	118	yes	222010	-
7325	scaffold_45	81493	82965	1472	159	yes	130747	-
7326	scaffold_45	85860	85892	32	6	yes	130768	-
7327	scaffold_45	86122	87058	936	112	yes	130768	-
7328	scaffold_45	89117	90459	1342	148	yes	247590	-
7329	scaffold_45	92328	92360	32	5	no	NA	NA
7330	scaffold_45	92504	93479	975	84	yes	327033,414010	-,+
7331	scaffold_45	93810	94666	856	86	yes	327033,414010	-,+
7332	scaffold_45	94797	94814	17	6	no	NA	NA
7333	scaffold_45	97847	98312	465	52	yes	395308	-
7334	scaffold_45	100484	101916	1432	151	yes	327038	+
7335	scaffold_45	112280	113328	1048	171	no	NA	NA
7336	scaffold_45	113815	115669	1854	261	no	NA	NA
7337	scaffold_45	125442	125450	8	4	yes	327047	+
7338	scaffold_45	125592	126520	928	97	yes	327047	+
7339	scaffold_45	132694	133568	874	93	yes	327050	-
7340	scaffold_45	136745	137869	1124	108	yes	327051	-
7341	scaffold_45	140086	141187	1101	157	yes	327053	+
7342	scaffold_45	142798	144108	1310	131	yes	414020	+
7343	scaffold_45	151690	152262	572	44	no	NA	NA
7344	scaffold_45	158628	158649	21	6	no	NA	NA
7345	scaffold_45	161680	162668	988	123	yes	395319	-
7346	scaffold_45	162965	164062	1097	126	yes	395319,327074,428753	-,+,+
7347	scaffold_45	168413	169558	1145	152	yes	327076	-
7348	scaffold_45	175589	175797	208	12	yes	395323	-
7349	scaffold_45	181881	182647	766	79	no	NA	NA
7350	scaffold_45	185671	187007	1336	150	yes	414029	-
7351	scaffold_45	188950	189908	958	93	yes	131237	+
7352	scaffold_45	194844	196371	1527	147	no	NA	NA
7353	scaffold_45	204281	204704	423	41	yes	327094	-
7354	scaffold_45	204819	204886	67	10	yes	327094	-
7355	scaffold_45	207136	208389	1253	132	no	NA	NA
7356	scaffold_45	208901	210380	1479	162	yes	247610	-
7357	scaffold_45	210781	212174	1393	165	yes	247610,327101	-,-
7358	scaffold_45	214157	215393	1236	154	yes	395329	-
7359	scaffold_45	221437	222376	939	128	yes	327104,395331	-,+
7360	scaffold_45	231385	232399	1014	65	yes	395334	+
7361	scaffold_45	232568	232659	91	18	no	NA	NA
7362	scaffold_45	232920	232967	47	6	no	NA	NA
7363	scaffold_45	237100	238244	1144	164	yes	327113	-
7364	scaffold_45	238431	240056	1625	213	yes	327113,428771	-,-
7365	scaffold_45	241997	243087	1090	87	yes	327117	-
7366	scaffold_45	247354	247973	619	39	yes	327119	+
7367	scaffold_45	283050	283064	14	6	no	NA	NA
7368	scaffold_45	285063	286374	1311	132	yes	327125	-
7369	scaffold_45	287910	288049	139	9	yes	377347	+
7370	scaffold_45	296954	298107	1153	113	no	NA	NA
7371	scaffold_45	299282	299298	16	4	no	NA	NA
7372	scaffold_45	306255	307506	1251	183	yes	298651,428782	-,+
7373	scaffold_45	315381	315942	561	73	yes	327136	+
7374	scaffold_45	321804	321870	66	12	yes	327137	-
7375	scaffold_45	322017	322362	345	30	yes	327137	-
7376	scaffold_45	341802	342509	707	107	no	NA	NA
7377	scaffold_45	373883	373889	6	4	no	NA	NA
7378	scaffold_45	410264	410515	251	31	yes	395355	-
7379	scaffold_45	421086	421824	738	63	yes	131607	-
7380	scaffold_45	430369	430894	525	92	yes	428802	+
7381	scaffold_45	434592	435979	1387	165	yes	327151	+
7382	scaffold_45	445467	445849	382	40	yes	327157	+
7383	scaffold_45	468733	469567	834	64	yes	298689	+
7384	scaffold_45	477775	477782	7	4	yes	222053	-
7385	scaffold_45	483372	484649	1277	140	yes	327168	+
7386	scaffold_45	487159	488436	1277	125	yes	131727,327170	+,+
7387	scaffold_45	488734	490111	1377	148	yes	327170	+
7388	scaffold_45	502453	503214	761	91	no	NA	NA
7389	scaffold_45	503594	504444	850	58	yes	327178	-
7390	scaffold_45	514186	514199	13	4	yes	298700	+
7391	scaffold_45	518189	518644	455	26	yes	395379	+
7392	scaffold_45	523639	524225	586	53	yes	327179	+
7393	scaffold_45	538380	539146	766	82	yes	131821	-
7394	scaffold_45	621983	623002	1019	149	yes	377422,395393	+,+
7395	scaffold_45	628142	629021	879	95	yes	221990	+
7396	scaffold_45	648052	649012	960	124	yes	131924	+
7397	scaffold_45	654454	655536	1082	165	yes	428839	-
7398	scaffold_45	656212	656232	20	8	yes	395400	+
7399	scaffold_45	656639	657357	718	80	yes	395400	+
7400	scaffold_45	661223	662053	830	96	yes	395401	+
7401	scaffold_45	670042	670086	44	12	no	NA	NA
7402	scaffold_45	675917	675927	10	4	no	NA	NA
7403	scaffold_127	16145	17736	1591	142	yes	406695	+
7404	scaffold_127	28138	29449	1311	128	yes	336242	-
7405	scaffold_127	31899	32470	571	64	yes	432506	-
7406	scaffold_127	35241	35680	439	52	yes	398954	-
7407	scaffold_127	40436	41723	1287	119	yes	336248	+
7408	scaffold_127	46970	48607	1637	124	yes	336249	-
7409	scaffold_127	50260	51158	898	65	yes	32687	-
7410	scaffold_127	52290	52721	431	64	yes	432512	-
7411	scaffold_127	53536	55563	2027	175	yes	336252,336253	-,+
7412	scaffold_127	69610	70885	1275	149	yes	432517	+
7413	scaffold_127	75097	76403	1306	158	yes	336263	-
7414	scaffold_127	80068	80107	39	12	no	NA	NA
7415	scaffold_127	83214	83262	48	11	no	NA	NA
7416	scaffold_127	83740	83758	18	5	no	NA	NA
7417	scaffold_127	86689	86728	39	12	no	NA	NA
7418	scaffold_127	89836	89883	47	12	no	NA	NA
7419	scaffold_127	90361	90380	19	6	no	NA	NA
7420	scaffold_46	5941	6864	923	61	yes	395406	+
7421	scaffold_46	7350	7359	9	4	no	NA	NA
7422	scaffold_46	66637	66888	251	36	yes	428852	-
7423	scaffold_46	75500	75613	113	22	yes	395414	-
7424	scaffold_46	88406	89428	1022	96	yes	395416	+
7425	scaffold_46	118861	119594	733	72	no	NA	NA
7426	scaffold_46	137768	138450	682	87	no	NA	NA
7427	scaffold_46	153683	155201	1518	152	no	NA	NA
7428	scaffold_46	176995	178117	1122	129	no	NA	NA
7429	scaffold_46	191344	191545	201	18	yes	327287	-
7430	scaffold_46	196330	197275	945	105	yes	222100	+
7431	scaffold_46	234104	234218	114	17	no	NA	NA
7432	scaffold_46	234482	234509	27	7	no	NA	NA
7433	scaffold_46	346428	346494	66	18	no	NA	NA
7434	scaffold_46	365883	368258	2375	238	yes	428883	-
7435	scaffold_46	368406	369504	1098	115	no	NA	NA
7436	scaffold_46	371274	371458	184	7	yes	298793	-
7437	scaffold_46	371956	372860	904	99	no	NA	NA
7438	scaffold_46	404245	405196	951	125	no	NA	NA
7439	scaffold_46	412301	412336	35	6	yes	327354	-
7440	scaffold_46	412576	413054	478	44	yes	327354	-
7441	scaffold_46	425912	427148	1236	115	yes	407687	+
7442	scaffold_46	439691	440622	931	101	yes	298800	-
7443	scaffold_46	446494	446519	25	6	no	NA	NA
7444	scaffold_46	446820	446991	171	20	yes	395446	-
7445	scaffold_46	452151	452898	747	79	yes	298802	-
7446	scaffold_46	460256	460299	43	14	no	NA	NA
7447	scaffold_46	501120	501140	20	6	no	NA	NA
7448	scaffold_46	501439	501475	36	10	no	NA	NA
7449	scaffold_46	501598	502913	1315	149	no	NA	NA
7450	scaffold_46	503151	503467	316	31	no	NA	NA
7451	scaffold_46	515374	515383	9	4	no	NA	NA
7452	scaffold_46	516498	516512	14	4	no	NA	NA
7453	scaffold_46	516981	517004	23	8	no	NA	NA
7454	scaffold_46	528515	528589	74	11	no	NA	NA
7455	scaffold_46	528743	528750	7	6	no	NA	NA
7456	scaffold_46	529296	529325	29	8	no	NA	NA
7457	scaffold_46	529790	529809	19	4	yes	407715	+
7458	scaffold_46	552911	552953	42	12	no	NA	NA
7459	scaffold_46	553141	553176	35	12	no	NA	NA
7460	scaffold_46	569746	570511	765	59	yes	428896	-
7461	scaffold_46	576040	576729	689	52	yes	327376	-
7462	scaffold_46	593084	593091	7	4	no	NA	NA
7463	scaffold_46	593174	594425	1251	182	yes	377594	-
7464	scaffold_46	624859	624941	82	18	yes	407734	-
7465	scaffold_46	631392	632165	773	116	no	NA	NA
7466	scaffold_46	632500	632764	264	24	no	NA	NA
7467	scaffold_46	632921	632957	36	8	no	NA	NA
7468	scaffold_46	636680	636720	40	10	no	NA	NA
7469	scaffold_46	636991	637342	351	43	no	NA	NA
7470	scaffold_46	637830	638781	951	96	no	NA	NA
7471	scaffold_46	639960	640208	248	13	no	NA	NA
7472	scaffold_46	641869	641880	11	3	no	NA	NA
7473	scaffold_46	644981	644996	15	6	no	NA	NA
7474	scaffold_46	645518	645561	43	9	no	NA	NA
7475	scaffold_46	651662	651717	55	15	no	NA	NA
7476	scaffold_46	652848	652891	43	9	no	NA	NA
7477	scaffold_46	660773	660942	169	20	no	NA	NA
7478	scaffold_46	661083	661152	69	22	no	NA	NA
7479	scaffold_46	661450	661585	135	25	yes	395460	-
7480	scaffold_46	661771	662194	423	45	yes	395460	-
7481	scaffold_46	662423	662463	40	6	no	NA	NA
7482	scaffold_46	663982	664177	195	26	no	NA	NA
7483	scaffold_46	664354	664737	383	76	no	NA	NA
7484	scaffold_46	665024	665974	950	148	no	NA	NA
7485	scaffold_125	41986	42000	14	6	yes	303299,432486	-,+
7486	scaffold_125	42425	43593	1168	125	yes	303299,432486	-,+
7487	scaffold_125	53544	53553	9	4	no	NA	NA
7488	scaffold_125	66478	67379	901	89	yes	303309	+
7489	scaffold_125	71474	73230	1756	231	yes	32469,415607	+,+
7490	scaffold_149	3111	3150	39	12	no	NA	NA
7491	scaffold_149	6287	6304	17	4	no	NA	NA
7492	scaffold_149	6783	6806	23	5	no	NA	NA
7493	scaffold_149	46200	46414	214	32	no	NA	NA
7494	scaffold_149	46515	46562	47	13	no	NA	NA
7495	scaffold_149	46670	46691	21	7	no	NA	NA
7496	scaffold_256	5233	5252	19	6	no	NA	NA
7497	scaffold_256	8470	8489	19	6	no	NA	NA
7498	scaffold_256	11707	11725	18	5	no	NA	NA
7499	scaffold_365	8318	8368	50	11	no	NA	NA
7500	scaffold_20	37323	38773	1450	159	yes	218484	-
7501	scaffold_20	40814	42029	1215	120	yes	69533	+
7502	scaffold_20	43929	45795	1866	194	yes	416454	+
7503	scaffold_20	50724	51741	1017	96	yes	244437	+
7504	scaffold_20	59442	60225	783	61	yes	318591	-
7505	scaffold_20	60493	62323	1830	176	yes	318591	-
7506	scaffold_20	63748	64726	978	119	yes	318593	+
7507	scaffold_20	70112	71685	1573	178	yes	69616	-
7508	scaffold_20	75126	75543	417	50	yes	318596	-
7509	scaffold_20	82654	82794	140	18	yes	391833	-
7510	scaffold_20	82865	83173	308	30	yes	391833	-
7511	scaffold_20	104940	105171	231	18	yes	218450,318603	+,+
7512	scaffold_20	115575	116656	1081	137	no	NA	NA
7513	scaffold_20	117693	118782	1089	60	yes	318613	+
7514	scaffold_20	150810	150824	14	6	yes	416479	-
7515	scaffold_20	150982	151211	229	22	yes	416479	-
7516	scaffold_20	155966	156878	912	88	yes	416481	+
7517	scaffold_20	184378	184506	128	17	no	NA	NA
7518	scaffold_20	184647	184891	244	30	no	NA	NA
7519	scaffold_20	212170	213131	961	96	no	NA	NA
7520	scaffold_20	213494	214240	746	72	no	NA	NA
7521	scaffold_20	225841	227510	1669	185	yes	425222	-
7522	scaffold_20	231669	231720	51	9	yes	231927	-
7523	scaffold_20	231905	231912	7	3	yes	231927	-
7524	scaffold_20	234364	234375	11	6	no	NA	NA
7525	scaffold_20	234525	234551	26	6	no	NA	NA
7526	scaffold_20	234793	235673	880	68	yes	69848	+
7527	scaffold_20	255124	256567	1443	174	yes	391863	+
7528	scaffold_20	257180	258833	1653	164	yes	385475	+
7529	scaffold_20	259673	261212	1539	170	yes	69899	+
7530	scaffold_20	261314	261331	17	6	no	NA	NA
7531	scaffold_20	273588	274451	863	45	no	NA	NA
7532	scaffold_20	304746	306276	1530	172	yes	318672	+
7533	scaffold_20	306546	306576	30	6	no	NA	NA
7534	scaffold_20	309774	310469	695	70	yes	231944	-
7535	scaffold_20	311144	311970	826	73	yes	318677	-
7536	scaffold_20	343477	343485	8	4	yes	416531	-
7537	scaffold_20	347608	348220	612	58	no	NA	NA
7538	scaffold_20	348455	349822	1367	177	yes	416533	+
7539	scaffold_20	363787	363856	69	13	yes	70051	-
7540	scaffold_20	365363	366140	777	116	no	NA	NA
7541	scaffold_20	372526	373164	638	51	yes	218356	+
7542	scaffold_20	373560	373685	125	31	no	NA	NA
7543	scaffold_20	381060	382716	1656	184	yes	70092	+
7544	scaffold_20	391857	392623	766	115	yes	318713	-
7545	scaffold_20	393786	394351	565	31	no	NA	NA
7546	scaffold_20	401329	402095	766	33	yes	294390	+
7547	scaffold_20	435258	436634	1376	133	no	NA	NA
7548	scaffold_20	441189	441562	373	29	yes	318721	-
7549	scaffold_20	442078	443331	1253	65	yes	318721	-
7550	scaffold_20	458244	458527	283	14	yes	318729	+
7551	scaffold_20	485628	485970	342	22	yes	70240	+
7552	scaffold_20	490316	491506	1190	155	yes	425277	+
7553	scaffold_20	504335	505923	1588	173	yes	391915	-
7554	scaffold_20	507206	508392	1186	124	yes	318739,318741	-,+
7555	scaffold_20	513141	514711	1570	165	yes	231967	-
7556	scaffold_20	516538	518111	1573	138	yes	416571	+
7557	scaffold_20	519708	520849	1141	119	no	NA	NA
7558	scaffold_20	533186	534544	1358	135	no	NA	NA
7559	scaffold_20	545688	546844	1156	182	yes	318757	+
7560	scaffold_20	550837	551588	751	50	yes	425288	-
7561	scaffold_20	553661	554627	966	108	yes	318762	-
7562	scaffold_20	559298	560661	1363	159	yes	318764	+
7563	scaffold_20	563876	565162	1286	117	yes	70426,318770	+,+
7564	scaffold_20	573534	573549	15	6	yes	416584	+
7565	scaffold_20	574136	575024	888	90	no	NA	NA
7566	scaffold_20	583119	584176	1057	70	yes	318776	+
7567	scaffold_20	594825	595872	1047	56	yes	318781	+
7568	scaffold_20	600364	601419	1055	126	yes	70489,318783	+,-
7569	scaffold_20	601619	602407	788	102	yes	70489,318783	+,-
7570	scaffold_20	605382	606367	985	89	yes	70503	-
7571	scaffold_20	606644	607141	497	45	yes	70503,318791	-,+
7572	scaffold_20	607640	608964	1324	161	yes	318791	+
7573	scaffold_20	615630	615641	11	4	no	NA	NA
7574	scaffold_20	622860	624268	1408	150	yes	318794	-
7575	scaffold_20	626350	627630	1280	127	yes	294441	+
7576	scaffold_20	631942	632740	798	78	yes	318799	+
7577	scaffold_20	636906	637996	1090	148	yes	318801	+
7578	scaffold_20	639900	640047	147	15	yes	318807	+
7579	scaffold_20	642267	643117	850	118	yes	318815	+
7580	scaffold_20	656479	657134	655	96	yes	318822	-
7581	scaffold_20	660415	661406	991	92	yes	318824	-
7582	scaffold_20	661677	664189	2512	275	yes	318824,318826	-,-
7583	scaffold_20	672456	672540	84	26	no	NA	NA
7584	scaffold_20	676432	677972	1540	181	yes	318835	+
7585	scaffold_20	680659	682322	1663	142	no	NA	NA
7586	scaffold_20	686945	688292	1347	153	yes	318853	+
7587	scaffold_20	691480	692637	1157	113	yes	425315	-
7588	scaffold_20	694095	695174	1079	132	yes	425316	-
7589	scaffold_20	695332	695362	30	4	yes	425316	-
7590	scaffold_20	696673	698091	1418	140	yes	318860	+
7591	scaffold_20	705386	706750	1364	143	yes	218404	-
7592	scaffold_20	718607	718618	11	8	no	NA	NA
7593	scaffold_20	725206	726314	1108	127	yes	425320	-
7594	scaffold_20	726530	727632	1102	114	yes	425320,318870,371778	-,-,+
7595	scaffold_20	729966	731024	1058	106	yes	318872	-
7596	scaffold_20	731490	732523	1033	125	yes	318872,416622	-,+
7597	scaffold_20	741185	742398	1213	118	yes	232000	-
7598	scaffold_20	749285	750268	983	75	yes	318883	-
7599	scaffold_20	754510	754556	46	12	yes	294471	+
7600	scaffold_20	754682	754695	13	4	yes	294471	+
7601	scaffold_20	764022	764542	520	38	yes	425330	+
7602	scaffold_20	768362	769248	886	90	yes	391969	+
7603	scaffold_20	773241	774341	1100	135	yes	318894	-
7604	scaffold_20	776145	776955	810	75	yes	244537	-
7605	scaffold_20	777829	778574	745	91	yes	318898	+
7606	scaffold_20	779588	779981	393	27	yes	71034	+
7607	scaffold_20	780128	780136	8	4	yes	71034	+
7608	scaffold_20	784443	786028	1585	155	no	NA	NA
7609	scaffold_20	786181	786196	15	6	no	NA	NA
7610	scaffold_20	793383	794211	828	97	yes	318906,425338	+,-
7611	scaffold_20	794450	795414	964	130	yes	318906,425338	+,-
7612	scaffold_20	805436	806825	1389	125	yes	318909	+
7613	scaffold_20	814384	815848	1464	204	yes	425343	+
7614	scaffold_20	824288	825990	1702	209	yes	294486	-
7615	scaffold_20	827067	827688	621	72	yes	218422	+
7616	scaffold_20	838239	838632	393	33	yes	391985	-
7617	scaffold_20	840365	841600	1235	119	yes	244556	-
7618	scaffold_20	844789	846171	1382	186	yes	318926	+
7619	scaffold_20	852110	853550	1440	164	yes	416649	-
7620	scaffold_20	860558	862126	1568	125	yes	294493	-
7621	scaffold_20	874829	875461	632	59	yes	294494	-
7622	scaffold_20	876063	877135	1072	94	yes	416653	-
7623	scaffold_20	880662	881793	1131	131	yes	71281	-
7624	scaffold_20	887236	888097	861	70	yes	318936,318938	-,-
7625	scaffold_20	888265	888460	195	16	yes	318938	-
7626	scaffold_20	889878	890809	931	83	yes	318939	-
7627	scaffold_20	895391	895403	12	4	yes	425358	+
7628	scaffold_20	915303	916262	959	82	yes	318945	-
7629	scaffold_20	916898	917928	1030	102	yes	318945,318946	-,-
7630	scaffold_20	919989	920734	745	48	yes	318947	+
7631	scaffold_20	923235	924364	1129	61	yes	318951	+
7632	scaffold_20	924699	925651	952	93	yes	318952	-
7633	scaffold_20	927146	928314	1168	116	yes	318953	-
7634	scaffold_20	955921	956358	437	133	no	NA	NA
7635	scaffold_20	971439	972347	908	81	yes	294524	+
7636	scaffold_20	972483	972492	9	4	yes	294524	+
7637	scaffold_20	1010511	1011079	568	81	no	NA	NA
7638	scaffold_20	1011894	1012153	259	36	yes	318969	-
7639	scaffold_20	1016707	1017404	697	68	yes	294531	-
7640	scaffold_20	1022398	1023757	1359	125	no	NA	NA
7641	scaffold_20	1043057	1043959	902	89	no	NA	NA
7642	scaffold_20	1060284	1060757	473	39	yes	232066	-
7643	scaffold_20	1064182	1064713	531	49	yes	318985	+
7644	scaffold_20	1080758	1081519	761	52	yes	318988	-
7645	scaffold_20	1086071	1086979	908	106	yes	318990	-
7646	scaffold_20	1090262	1091673	1411	165	yes	416716	-
7647	scaffold_20	1093835	1094065	230	20	yes	318993	-
7648	scaffold_20	1095118	1096261	1143	103	yes	425394	+
7649	scaffold_20	1098635	1099869	1234	136	yes	416719	-
7650	scaffold_121	6425	6455	30	9	no	NA	NA
7651	scaffold_121	22070	22295	225	39	no	NA	NA
7652	scaffold_121	30206	32464	2258	162	yes	406833	+
7653	scaffold_121	32625	32897	272	11	no	NA	NA
7654	scaffold_121	41698	42612	914	93	yes	368834	+
7655	scaffold_121	74001	75251	1250	183	yes	398867	+
7656	scaffold_121	79293	81204	1911	215	yes	238445	-
7657	scaffold_121	86225	87706	1481	127	yes	398869	-
7658	scaffold_121	90143	91119	976	121	yes	336039	-
7659	scaffold_121	91761	92916	1155	72	yes	336040	-
7660	scaffold_121	93651	94379	728	70	yes	336041	-
7661	scaffold_121	96551	96557	6	4	no	NA	NA
7662	scaffold_121	106242	107697	1455	165	yes	225626	+
7663	scaffold_165	8936	9934	998	126	yes	432736	-
7664	scaffold_165	27233	27918	685	84	no	NA	NA
7665	scaffold_165	31898	32153	255	20	no	NA	NA
7666	scaffold_273	6301	6833	532	36	no	NA	NA
7667	scaffold_273	10461	10480	19	6	no	NA	NA
7668	scaffold_330	7875	9011	1136	112	yes	432958	-
7669	scaffold_115	5552	5636	84	26	no	NA	NA
7670	scaffold_115	30711	31734	1023	125	yes	335759	+
7671	scaffold_115	34681	35922	1241	108	yes	335763	-
7672	scaffold_115	37739	39042	1303	159	yes	335764	+
7673	scaffold_115	50363	51341	978	126	yes	335773,398754	+,-
7674	scaffold_115	51821	53065	1244	163	yes	335773	+
7675	scaffold_115	58013	58019	6	4	yes	335781	+
7676	scaffold_115	58256	59649	1393	138	yes	335781	+
7677	scaffold_115	64560	65467	907	87	yes	28204	-
7678	scaffold_115	73373	74423	1050	129	yes	335784	+
7679	scaffold_115	87289	88982	1693	146	yes	335790	-
7680	scaffold_115	91908	91915	7	4	no	NA	NA
7681	scaffold_115	92087	93075	988	136	yes	432310,432311	-,+
7682	scaffold_115	93285	94349	1064	150	yes	432310,432311	-,+
7683	scaffold_115	97491	98597	1106	158	yes	335795	-
7684	scaffold_115	99511	100489	978	111	yes	335808	+
7685	scaffold_115	110030	111596	1566	194	yes	335813	+
7686	scaffold_115	124542	124930	388	43	no	NA	NA
7687	scaffold_115	134579	135344	765	70	yes	225464	-
7688	scaffold_115	139045	139906	861	85	yes	303091	-
7689	scaffold_115	144252	144834	582	59	no	NA	NA
7690	scaffold_180	7254	7382	128	36	no	NA	NA
7691	scaffold_180	24272	24316	44	15	no	NA	NA
7692	scaffold_233	5671	6486	815	95	yes	432827	-
7693	scaffold_233	10541	11572	1031	98	yes	399245	+
7694	scaffold_110	9029	10015	986	123	yes	398640	+
7695	scaffold_110	12349	13467	1118	121	yes	335382	+
7696	scaffold_110	20112	21485	1373	132	yes	398642	-
7697	scaffold_110	24390	25506	1116	67	yes	335390	-
7698	scaffold_110	28314	28338	24	8	no	NA	NA
7699	scaffold_110	32253	33383	1130	99	yes	398644	-
7700	scaffold_110	34526	36110	1584	146	yes	411130	+
7701	scaffold_110	52293	53636	1343	165	yes	250507	-
7702	scaffold_110	57161	57273	112	18	no	NA	NA
7703	scaffold_110	57358	58007	649	62	yes	302950,335403	-,+
7704	scaffold_110	58165	58921	756	96	yes	302950,335403	-,+
7705	scaffold_110	84005	84014	9	4	no	NA	NA
7706	scaffold_110	134864	136264	1400	143	yes	26682	+
7707	scaffold_110	152919	154013	1094	125	yes	335442	-
7708	scaffold_110	173838	173898	60	13	no	NA	NA
7709	scaffold_47	389	884	495	33	no	NA	NA
7710	scaffold_47	20270	21386	1116	129	yes	134060	-
7711	scaffold_47	29605	30909	1304	115	yes	411944	-
7712	scaffold_47	42797	44311	1514	194	yes	327405	-
7713	scaffold_47	50244	51233	989	143	yes	327408	-
7714	scaffold_47	61096	61107	11	4	no	NA	NA
7715	scaffold_47	61523	62195	672	34	yes	411948	-
7716	scaffold_47	81432	82468	1036	99	yes	411950	-
7717	scaffold_47	84842	86206	1364	128	yes	366158	+
7718	scaffold_47	89894	90810	916	86	yes	327422	+
7719	scaffold_47	90980	90990	10	4	yes	327422	+
7720	scaffold_47	92833	92846	13	8	no	NA	NA
7721	scaffold_47	95096	96562	1466	158	yes	134217,134228	-,-
7722	scaffold_47	100207	101639	1432	129	yes	428921	+
7723	scaffold_47	101779	101886	107	6	no	NA	NA
7724	scaffold_47	104861	105894	1033	145	yes	327427,327428	-,+
7725	scaffold_47	106087	106986	899	87	yes	327427,327428	-,+
7726	scaffold_47	110233	111690	1457	196	yes	327430	-
7727	scaffold_47	119047	119760	713	70	yes	428927	+
7728	scaffold_47	121091	122184	1093	137	yes	428928	-
7729	scaffold_47	122541	124095	1554	198	yes	428928,411962	-,+
7730	scaffold_47	129055	129421	366	40	no	NA	NA
7731	scaffold_47	129553	129559	6	4	no	NA	NA
7732	scaffold_47	129723	130315	592	78	yes	395485	-
7733	scaffold_47	132424	132671	247	8	no	NA	NA
7734	scaffold_47	132861	133239	378	29	yes	327435	+
7735	scaffold_47	142746	143156	410	27	no	NA	NA
7736	scaffold_47	152666	153199	533	49	yes	235301	-
7737	scaffold_47	154504	154925	421	47	yes	327442	-
7738	scaffold_47	155790	156205	415	54	yes	327444	+
7739	scaffold_47	158315	158640	325	24	yes	134421	+
7740	scaffold_47	170691	171215	524	54	yes	327453	+
7741	scaffold_47	173534	173547	13	6	yes	327455	+
7742	scaffold_47	175683	175715	32	10	yes	377682	+
7743	scaffold_47	179458	180137	679	72	yes	395499	+
7744	scaffold_47	195621	197814	2193	176	yes	395502	+
7745	scaffold_47	204183	205644	1461	199	yes	298881	-
7746	scaffold_47	205742	205749	7	4	yes	298881	-
7747	scaffold_47	220790	221697	907	146	yes	327466,327469	-,+
7748	scaffold_47	224025	224998	973	92	yes	327473	-
7749	scaffold_47	227085	228367	1282	151	yes	395508	-
7750	scaffold_47	231162	231900	738	90	no	NA	NA
7751	scaffold_47	256903	257783	880	75	yes	366165	-
7752	scaffold_47	260571	262173	1602	164	yes	327501	-
7753	scaffold_47	264246	265307	1061	187	yes	327503	+
7754	scaffold_47	269529	271282	1753	144	yes	298896	+
7755	scaffold_47	278958	279639	681	61	yes	247734	-
7756	scaffold_47	285978	287239	1261	176	yes	134717	+
7757	scaffold_47	289067	290585	1518	249	yes	327511	+
7758	scaffold_47	293277	293381	104	16	yes	327513	-
7759	scaffold_47	301011	302503	1492	175	no	NA	NA
7760	scaffold_47	310993	312022	1029	85	no	NA	NA
7761	scaffold_47	328567	329735	1168	95	no	NA	NA
7762	scaffold_47	335511	335938	427	32	no	NA	NA
7763	scaffold_47	336230	336561	331	34	no	NA	NA
7764	scaffold_47	336748	339793	3045	313	no	NA	NA
7765	scaffold_47	340025	340927	902	127	no	NA	NA
7766	scaffold_47	360834	361862	1028	40	yes	247739	+
7767	scaffold_47	361981	361993	12	4	no	NA	NA
7768	scaffold_47	381116	382576	1460	162	yes	134880	-
7769	scaffold_47	385643	386511	868	117	yes	327554	-
7770	scaffold_47	386735	388340	1605	172	yes	327554,327556	-,+
7771	scaffold_47	391808	393175	1367	156	yes	327558	-
7772	scaffold_47	398028	398955	927	97	yes	327562	-
7773	scaffold_47	403993	405198	1205	147	yes	222137	-
7774	scaffold_47	406427	407743	1316	144	yes	327573	+
7775	scaffold_47	407905	407917	12	4	no	NA	NA
7776	scaffold_47	410560	411912	1352	96	yes	327575	+
7777	scaffold_47	412042	412078	36	4	no	NA	NA
7778	scaffold_47	418401	419779	1378	175	yes	428982	-
7779	scaffold_47	420799	422149	1350	132	yes	327581	+
7780	scaffold_47	429280	430606	1326	169	yes	428985	-
7781	scaffold_47	431981	433605	1624	193	yes	428986	+
7782	scaffold_47	459162	460708	1546	102	yes	235364	-
7783	scaffold_47	467280	467287	7	4	no	NA	NA
7784	scaffold_47	471804	472997	1193	126	yes	327597	-
7785	scaffold_47	478056	479180	1124	139	yes	327600	-
7786	scaffold_47	482699	483892	1193	152	yes	412038	-
7787	scaffold_47	485688	487100	1412	136	yes	222207	-
7788	scaffold_47	492118	492138	20	6	no	NA	NA
7789	scaffold_47	492281	493412	1131	87	yes	247775	-
7790	scaffold_47	494339	495675	1336	158	yes	235380	+
7791	scaffold_47	502781	503913	1132	123	yes	327609	+
7792	scaffold_47	507116	508424	1308	122	yes	298936	+
7793	scaffold_47	517996	518716	720	46	yes	412048	-
7794	scaffold_47	538240	539535	1295	160	yes	395555	+
7795	scaffold_47	542377	544455	2078	220	yes	327624,327627	+,+
7796	scaffold_47	549318	550245	927	85	yes	412054	+
7797	scaffold_47	553476	554503	1027	179	no	NA	NA
7798	scaffold_47	559111	560130	1019	94	yes	327638	+
7799	scaffold_47	563125	563969	844	74	yes	395561	+
7800	scaffold_47	572420	573772	1352	131	yes	327643	+
7801	scaffold_47	591543	592117	574	44	yes	135485	-
7802	scaffold_47	601345	602141	796	73	yes	327658	-
7803	scaffold_47	603369	604636	1267	150	yes	429012	-
7804	scaffold_47	608297	608459	162	12	yes	429013	-
7805	scaffold_47	622273	622591	318	18	yes	135542	+
7806	scaffold_47	629058	629101	43	6	no	NA	NA
7807	scaffold_47	629605	629779	174	16	no	NA	NA
7808	scaffold_107	920	1129	209	28	yes	410228	+
7809	scaffold_107	8902	10203	1301	164	yes	334975	+
7810	scaffold_107	13547	14583	1036	120	yes	334978	+
7811	scaffold_107	17405	17430	25	10	yes	432096	+
7812	scaffold_107	22900	23722	822	95	yes	334982	-
7813	scaffold_107	25143	26637	1494	165	yes	22257	+
7814	scaffold_107	35937	36802	865	125	yes	410234	-
7815	scaffold_107	39807	39813	6	4	yes	22366	+
7816	scaffold_107	43728	43732	4	4	no	NA	NA
7817	scaffold_107	44163	45199	1036	111	no	NA	NA
7818	scaffold_107	52817	53565	748	96	yes	302833	+
7819	scaffold_107	66907	68040	1133	96	yes	432104	-
7820	scaffold_107	77528	78377	849	91	yes	335017	+
7821	scaffold_107	88905	90315	1410	191	yes	335023	+
7822	scaffold_107	95598	96937	1339	142	yes	22639	-
7823	scaffold_107	98213	99661	1448	167	yes	410248	+
7824	scaffold_107	124873	125714	841	79	yes	302848	-
7825	scaffold_107	139122	139381	259	17	yes	335040	-
7826	scaffold_107	143193	144218	1025	93	yes	398570	-
7827	scaffold_107	148752	149692	940	130	yes	335043	-
7828	scaffold_107	166638	167765	1127	137	yes	398573	+
7829	scaffold_107	169362	170528	1166	138	yes	432121	-
7830	scaffold_107	174203	175489	1286	123	yes	398575	-
7831	scaffold_107	176133	177559	1426	180	no	NA	NA
7832	scaffold_107	186226	187162	936	115	yes	22838	-
7833	scaffold_229	8969	8983	14	6	no	NA	NA
7834	scaffold_279	6980	7404	424	53	no	NA	NA
7835	scaffold_48	24207	25625	1418	105	no	NA	NA
7836	scaffold_48	28857	30307	1450	157	yes	135699	+
7837	scaffold_48	34736	35769	1033	114	yes	429020	+
7838	scaffold_48	47943	47981	38	10	no	NA	NA
7839	scaffold_48	49852	50989	1137	126	yes	135735	-
7840	scaffold_48	51156	51341	185	14	yes	135735	-
7841	scaffold_48	65239	65928	689	71	no	NA	NA
7842	scaffold_48	68162	68196	34	8	yes	327683	-
7843	scaffold_48	68280	69334	1054	145	yes	327683	-
7844	scaffold_48	79278	79285	7	4	no	NA	NA
7845	scaffold_48	86423	88019	1596	198	yes	395579	+
7846	scaffold_48	90722	90779	57	14	no	NA	NA
7847	scaffold_48	99715	100943	1228	126	yes	298970	-
7848	scaffold_48	101297	102259	962	96	yes	298970	-
7849	scaffold_48	103086	103267	181	10	yes	429027	+
7850	scaffold_48	103495	103929	434	63	yes	429027	+
7851	scaffold_48	111087	111131	44	10	no	NA	NA
7852	scaffold_48	111853	112808	955	100	no	NA	NA
7853	scaffold_48	115420	115813	393	35	no	NA	NA
7854	scaffold_48	116458	117029	571	63	yes	429030,429031	-,+
7855	scaffold_48	131027	131052	25	10	no	NA	NA
7856	scaffold_48	135575	135913	338	49	no	NA	NA
7857	scaffold_48	150467	151134	667	46	no	NA	NA
7858	scaffold_48	151732	151809	77	6	no	NA	NA
7859	scaffold_48	152666	152711	45	12	no	NA	NA
7860	scaffold_48	173188	173863	675	63	no	NA	NA
7861	scaffold_48	181880	182825	945	95	no	NA	NA
7862	scaffold_48	182983	183144	161	4	no	NA	NA
7863	scaffold_48	198189	198206	17	4	yes	327711	-
7864	scaffold_48	205845	205899	54	6	yes	395590	-
7865	scaffold_48	206129	206583	454	56	yes	395590	-
7866	scaffold_48	206881	207369	488	54	no	NA	NA
7867	scaffold_48	207787	207934	147	8	no	NA	NA
7868	scaffold_48	213620	213827	207	20	yes	395591	-
7869	scaffold_48	219889	220613	724	61	yes	377803	-
7870	scaffold_48	220759	220766	7	4	yes	377803	-
7871	scaffold_48	220870	220902	32	6	yes	377803	-
7872	scaffold_48	228309	228825	516	52	yes	327715	-
7873	scaffold_48	229248	229498	250	25	yes	327715	-
7874	scaffold_48	239011	239623	612	59	no	NA	NA
7875	scaffold_48	239788	239802	14	4	no	NA	NA
7876	scaffold_48	239997	240175	178	19	no	NA	NA
7877	scaffold_48	241878	242066	188	16	yes	395594	+
7878	scaffold_48	242749	242816	67	14	no	NA	NA
7879	scaffold_48	242919	242959	40	7	no	NA	NA
7880	scaffold_48	243176	243329	153	12	no	NA	NA
7881	scaffold_48	243716	243881	165	13	no	NA	NA
7882	scaffold_48	253880	253886	6	4	no	NA	NA
7883	scaffold_48	267295	267304	9	5	no	NA	NA
7884	scaffold_48	277597	277946	349	56	no	NA	NA
7885	scaffold_48	284828	284850	22	6	no	NA	NA
7886	scaffold_48	285327	285568	241	28	no	NA	NA
7887	scaffold_48	288378	288437	59	10	no	NA	NA
7888	scaffold_48	311165	311265	100	15	yes	136440	-
7889	scaffold_48	316252	316262	10	4	no	NA	NA
7890	scaffold_48	340170	340177	7	4	no	NA	NA
7891	scaffold_48	341565	341628	63	10	no	NA	NA
7892	scaffold_48	342009	342065	56	16	no	NA	NA
7893	scaffold_48	342235	342247	12	6	yes	327737	+
7894	scaffold_48	343986	344062	76	16	no	NA	NA
7895	scaffold_48	344145	344178	33	8	no	NA	NA
7896	scaffold_48	344370	345624	1254	131	no	NA	NA
7897	scaffold_48	345820	346724	904	108	no	NA	NA
7898	scaffold_48	346858	346920	62	14	no	NA	NA
7899	scaffold_48	349943	350726	783	114	yes	136579,377806	-,-
7900	scaffold_48	365280	365290	10	4	no	NA	NA
7901	scaffold_48	365659	365831	172	26	no	NA	NA
7902	scaffold_48	375423	375442	19	6	no	NA	NA
7903	scaffold_48	377431	377452	21	6	no	NA	NA
7904	scaffold_48	377734	377747	13	4	no	NA	NA
7905	scaffold_48	384334	384384	50	10	no	NA	NA
7906	scaffold_48	384495	384500	5	4	no	NA	NA
7907	scaffold_48	386424	386446	22	4	no	NA	NA
7908	scaffold_48	392897	393375	478	40	no	NA	NA
7909	scaffold_48	393568	394356	788	104	no	NA	NA
7910	scaffold_48	395129	395140	11	4	no	NA	NA
7911	scaffold_48	399229	399449	220	18	no	NA	NA
7912	scaffold_48	399665	399931	266	30	no	NA	NA
7913	scaffold_48	411407	411672	265	42	no	NA	NA
7914	scaffold_48	412847	412909	62	6	no	NA	NA
7915	scaffold_48	415260	415265	5	4	no	NA	NA
7916	scaffold_48	415370	415430	60	14	no	NA	NA
7917	scaffold_48	416742	416764	22	8	no	NA	NA
7918	scaffold_48	421838	421863	25	8	no	NA	NA
7919	scaffold_48	449821	449844	23	10	no	NA	NA
7920	scaffold_48	456049	457227	1178	141	yes	395603	-
7921	scaffold_48	459070	459079	9	4	no	NA	NA
7922	scaffold_48	460149	460166	17	6	no	NA	NA
7923	scaffold_48	460345	460917	572	42	no	NA	NA
7924	scaffold_48	461019	461078	59	12	no	NA	NA
7925	scaffold_48	461704	461914	210	20	no	NA	NA
7926	scaffold_48	463492	463654	162	16	no	NA	NA
7927	scaffold_48	464023	464225	202	25	no	NA	NA
7928	scaffold_48	464592	464633	41	9	no	NA	NA
7929	scaffold_48	465138	465365	227	19	no	NA	NA
7930	scaffold_48	465499	465554	55	12	no	NA	NA
7931	scaffold_48	466742	467211	469	54	no	NA	NA
7932	scaffold_48	467644	467688	44	4	no	NA	NA
7933	scaffold_48	468290	468330	40	6	no	NA	NA
7934	scaffold_48	469287	469351	64	12	no	NA	NA
7935	scaffold_48	469442	469459	17	4	no	NA	NA
7936	scaffold_48	469804	469878	74	14	no	NA	NA
7937	scaffold_48	470151	471833	1682	150	no	NA	NA
7938	scaffold_48	472018	472265	247	26	yes	327766	+
7939	scaffold_48	472383	472410	27	10	yes	327766	+
7940	scaffold_48	475755	476277	522	51	yes	411884	+
7941	scaffold_48	478576	478910	334	40	yes	327767	+
7942	scaffold_48	479213	479398	185	13	yes	327767	+
7943	scaffold_48	481480	481555	75	12	no	NA	NA
7944	scaffold_48	481980	482514	534	60	yes	395606	+
7945	scaffold_48	485149	485271	122	12	no	NA	NA
7946	scaffold_48	485857	485877	20	6	no	NA	NA
7947	scaffold_48	486216	487126	910	84	yes	136726	+
7948	scaffold_48	491604	491846	242	19	yes	299008	+
7949	scaffold_48	491964	492023	59	7	yes	299008	+
7950	scaffold_48	494712	494822	110	13	no	NA	NA
7951	scaffold_48	495904	496015	111	19	yes	327772	+
7952	scaffold_48	496190	496241	51	10	yes	327772	+
7953	scaffold_48	498598	499184	586	55	yes	429062	+
7954	scaffold_48	499506	499575	69	12	yes	429062	+
7955	scaffold_48	501645	501786	141	16	no	NA	NA
7956	scaffold_48	502144	502834	690	51	yes	429063	+
7957	scaffold_48	504964	506093	1129	106	no	NA	NA
7958	scaffold_48	508475	508610	135	7	no	NA	NA
7959	scaffold_48	509278	509307	29	8	yes	327778	+
7960	scaffold_48	511653	511656	3	3	no	NA	NA
7961	scaffold_48	512655	513010	355	20	yes	429066	+
7962	scaffold_48	516093	516937	844	75	yes	327785	+
7963	scaffold_48	517258	517265	7	4	yes	327785	+
7964	scaffold_48	518945	520257	1312	106	yes	411895	+
7965	scaffold_48	522959	523199	240	17	yes	327790	+
7966	scaffold_48	525925	527313	1388	104	yes	136823	+
7967	scaffold_48	529445	530691	1246	121	yes	429070	+
7968	scaffold_48	532642	533797	1155	90	yes	429071	+
7969	scaffold_48	536089	537055	966	88	yes	327794	+
7970	scaffold_48	537234	537250	16	4	yes	327794	+
7971	scaffold_48	539598	540856	1258	99	yes	377843	+
7972	scaffold_48	542980	543469	489	44	no	NA	NA
7973	scaffold_48	543985	544013	28	8	yes	411902	+
7974	scaffold_48	546099	547203	1104	120	yes	299021	+
7975	scaffold_48	549438	549504	66	8	no	NA	NA
7976	scaffold_48	549658	549800	142	18	no	NA	NA
7977	scaffold_48	550007	550748	741	77	yes	429076	+
7978	scaffold_48	552744	553748	1004	89	yes	395621	+
7979	scaffold_48	556560	557452	892	58	yes	299024	+
7980	scaffold_48	557920	557940	20	3	yes	299024	+
7981	scaffold_48	560249	560317	68	8	no	NA	NA
7982	scaffold_48	561327	561561	234	24	yes	395623	+
7983	scaffold_48	563263	564609	1346	122	no	NA	NA
7984	scaffold_48	564804	565009	205	40	yes	327811	+
7985	scaffold_48	565172	565363	191	14	yes	327811	+
7986	scaffold_48	567022	568092	1070	118	yes	327813	+
7987	scaffold_48	568337	568621	284	24	yes	327813	+
7988	scaffold_48	568842	568935	93	8	yes	327813	+
7989	scaffold_48	572215	572265	50	10	yes	327814	+
7990	scaffold_48	572721	572752	31	10	no	NA	NA
7991	scaffold_48	574422	575106	684	76	yes	395627	+
7992	scaffold_48	575245	575315	70	12	yes	395627	+
7993	scaffold_48	578092	578121	29	8	yes	395628	+
7994	scaffold_48	580717	580927	210	30	yes	327819	+
7995	scaffold_48	581011	581142	131	9	yes	327819	+
7996	scaffold_48	582087	582300	213	24	no	NA	NA
7997	scaffold_48	582485	583227	742	91	yes	327822	+
7998	scaffold_48	586563	586601	38	14	yes	327824	+
7999	scaffold_48	586773	586802	29	5	yes	327824	+
8000	scaffold_48	590168	590195	27	8	yes	136968	+
8001	scaffold_48	593371	593454	83	8	yes	327827	+
8002	scaffold_48	593554	593575	21	6	yes	327827	+
8003	scaffold_48	596059	596092	33	8	no	NA	NA
8004	scaffold_48	596233	598172	1939	194	yes	327830	+
8005	scaffold_48	601957	602026	69	12	yes	411919	+
8006	scaffold_48	605397	605418	21	6	yes	327835	+
8007	scaffold_48	608009	608736	727	83	no	NA	NA
8008	scaffold_48	609082	609279	197	24	yes	299039	+
8009	scaffold_48	610588	610604	16	3	no	NA	NA
8010	scaffold_48	619105	619122	17	6	no	NA	NA
8011	scaffold_48	620430	620627	197	23	yes	299041	-
8012	scaffold_48	620973	621700	727	84	no	NA	NA
8013	scaffold_106	14861	15758	897	121	yes	334893	-
8014	scaffold_106	16187	17171	984	101	yes	334893,334894	-,+
8015	scaffold_106	29552	30175	623	75	yes	398519	-
8016	scaffold_106	81183	82355	1172	161	no	NA	NA
8017	scaffold_106	96784	98078	1294	108	yes	432072	-
8018	scaffold_106	98505	98571	66	16	yes	432072	-
8019	scaffold_106	113041	113831	790	101	yes	432075	-
8020	scaffold_106	114048	115446	1398	186	yes	302797	-
8021	scaffold_106	142970	143759	789	83	no	NA	NA
8022	scaffold_106	158628	159723	1095	103	yes	22067,302810,334941	+,-,-
8023	scaffold_106	159907	161099	1192	149	yes	22067,334941	+,-
8024	scaffold_106	169093	170180	1087	115	yes	22086,334949,334953	+,-,-
8025	scaffold_106	170348	171499	1151	136	yes	22086,334953,432085	+,-,+
8026	scaffold_106	185145	186272	1127	147	yes	334967,334968	-,+
8027	scaffold_248	1159	1715	556	72	no	NA	NA
8028	scaffold_49	1211	2101	890	117	yes	395640	+
8029	scaffold_49	11661	11689	28	6	no	NA	NA
8030	scaffold_49	13358	13377	19	6	no	NA	NA
8031	scaffold_49	14528	15681	1153	102	yes	222269	-
8032	scaffold_49	20206	21147	941	85	yes	429099	-
8033	scaffold_49	29634	29638	4	4	no	NA	NA
8034	scaffold_49	29914	31172	1258	153	yes	327855	-
8035	scaffold_49	35289	36589	1300	135	yes	395648	-
8036	scaffold_49	42353	42367	14	8	yes	401845	-
8037	scaffold_49	42455	43180	725	66	yes	401845	-
8038	scaffold_49	48652	49789	1137	146	yes	429102	+
8039	scaffold_49	56073	57023	950	100	yes	327869	-
8040	scaffold_49	63509	65215	1706	202	yes	137420	-
8041	scaffold_49	66190	67164	974	107	yes	395653	-
8042	scaffold_49	67428	68551	1123	129	yes	395653,137462	-,+
8043	scaffold_49	70959	72178	1219	157	yes	222273	+
8044	scaffold_49	72352	72359	7	3	yes	222273	+
8045	scaffold_49	85146	85883	737	80	yes	327888	+
8046	scaffold_49	86360	86434	74	9	no	NA	NA
8047	scaffold_49	86787	88250	1463	92	yes	327890	-
8048	scaffold_49	97299	98401	1102	136	yes	327893	-
8049	scaffold_49	114550	115963	1413	130	yes	401859	-
8050	scaffold_49	118904	119586	682	58	yes	137650	-
8051	scaffold_49	119946	120937	991	119	yes	137650	-
8052	scaffold_49	130158	131308	1150	112	yes	137675	+
8053	scaffold_49	133416	134580	1164	110	yes	327909	-
8054	scaffold_49	137235	137333	98	11	yes	235447	-
8055	scaffold_49	137524	137914	390	46	yes	235447	-
8056	scaffold_49	143300	144572	1272	91	yes	327916	-
8057	scaffold_49	150951	151720	769	106	yes	327917	-
8058	scaffold_49	162878	163914	1036	125	yes	327920	-
8059	scaffold_49	164135	165235	1100	109	yes	327920,235454	-,+
8060	scaffold_49	167206	168750	1544	179	yes	137831,137848	+,+
8061	scaffold_49	177073	178584	1511	148	yes	385921	-
8062	scaffold_49	182174	182635	461	28	yes	401873	+
8063	scaffold_49	194866	195528	662	101	yes	327933	-
8064	scaffold_49	198770	200011	1241	121	yes	327934	-
8065	scaffold_49	211217	212222	1005	110	no	NA	NA
8066	scaffold_49	214421	215741	1320	111	yes	327941	+
8067	scaffold_49	217978	219252	1274	128	yes	327944	-
8068	scaffold_49	231813	232910	1097	74	yes	327950	+
8069	scaffold_49	238855	240190	1335	169	yes	395687	-
8070	scaffold_49	240863	242059	1196	137	yes	138095	+
8071	scaffold_49	250925	252103	1178	92	yes	327960	+
8072	scaffold_49	259900	261461	1561	133	yes	299102	-
8073	scaffold_49	283145	284285	1140	128	yes	327970	+
8074	scaffold_49	285423	286780	1357	171	yes	299109	+
8075	scaffold_49	295869	296979	1110	112	yes	327976	+
8076	scaffold_49	297170	297180	10	4	yes	327976	+
8077	scaffold_49	309564	311799	2235	273	no	NA	NA
8078	scaffold_49	314881	316284	1403	107	yes	299115	+
8079	scaffold_49	323467	324445	978	142	no	NA	NA
8080	scaffold_49	329696	330497	801	84	yes	327992	-
8081	scaffold_49	343501	344250	749	111	yes	328003	-
8082	scaffold_49	344472	344487	15	3	yes	328003	-
8083	scaffold_49	345135	346321	1186	132	yes	328006	-
8084	scaffold_49	349775	350859	1084	122	no	NA	NA
8085	scaffold_49	359700	359982	282	30	yes	138390	+
8086	scaffold_49	360359	361092	733	85	yes	138390,328019	+,+
8087	scaffold_49	370094	371462	1368	172	yes	328023	+
8088	scaffold_49	371943	373310	1367	133	yes	328024	-
8089	scaffold_49	375193	375822	629	63	yes	328025	+
8090	scaffold_49	380601	382050	1449	143	yes	328028	+
8091	scaffold_49	388935	390033	1098	145	yes	247893	-
8092	scaffold_49	390381	391097	716	81	yes	247893	-
8093	scaffold_49	400204	401431	1227	92	yes	222336	-
8094	scaffold_49	404193	405540	1347	118	yes	328040	+
8095	scaffold_49	411085	411810	725	105	yes	299135	-
8096	scaffold_49	413075	414210	1135	138	yes	401922	+
8097	scaffold_49	434176	436036	1860	187	yes	328046	-
8098	scaffold_49	436633	438130	1497	143	yes	247906	+
8099	scaffold_49	441166	442136	970	87	yes	328050	-
8100	scaffold_49	451105	452298	1193	171	yes	429175	-
8101	scaffold_49	455331	456978	1647	177	yes	429176	-
8102	scaffold_49	459347	460314	967	118	yes	328058	+
8103	scaffold_49	471770	472774	1004	153	yes	395729	-
8104	scaffold_49	473700	474833	1133	130	yes	328065	+
8105	scaffold_49	480910	482180	1270	119	no	NA	NA
8106	scaffold_49	487070	488503	1433	143	yes	138816,328070	-,+
8107	scaffold_49	488796	489937	1141	167	yes	138816,328070	-,+
8108	scaffold_49	496084	496093	9	4	no	NA	NA
8109	scaffold_49	496211	497659	1448	209	yes	328074	-
8110	scaffold_49	505798	505887	89	12	no	NA	NA
8111	scaffold_49	505977	507317	1340	149	yes	429186	+
8112	scaffold_49	509803	510459	656	71	yes	328085,328086	-,+
8113	scaffold_49	510584	510630	46	8	yes	328085,328086	-,+
8114	scaffold_49	525381	526349	968	114	yes	138925	+
8115	scaffold_49	537192	538682	1490	177	yes	401947	-
8116	scaffold_49	539942	540780	838	73	yes	299159	+
8117	scaffold_49	545504	546964	1460	152	yes	328105	+
8118	scaffold_49	550400	551262	862	105	no	NA	NA
8119	scaffold_49	558036	559297	1261	134	no	NA	NA
8120	scaffold_49	571140	571618	478	40	yes	395749	+
8121	scaffold_49	571733	571789	56	6	no	NA	NA
8122	scaffold_49	579930	581117	1187	148	yes	401954,429199	-,+
8123	scaffold_49	592651	593589	938	96	yes	366200	+
8124	scaffold_49	602856	606106	3250	193	no	NA	NA
8125	scaffold_105	29650	30493	843	61	yes	334844	+
8126	scaffold_105	62284	62447	163	16	yes	334855	-
8127	scaffold_105	62583	62633	50	8	yes	334855	-
8128	scaffold_105	81642	81925	283	35	yes	334859	+
8129	scaffold_105	109560	110443	883	79	yes	334863	+
8130	scaffold_105	113677	114681	1004	116	no	NA	NA
8131	scaffold_105	117275	118089	814	63	yes	21782	+
8132	scaffold_105	118300	118325	25	8	no	NA	NA
8133	scaffold_105	135039	135846	807	58	yes	334869	-
8134	scaffold_105	141337	142227	890	89	no	NA	NA
8135	scaffold_105	151322	151390	68	16	no	NA	NA
8136	scaffold_105	152399	152467	68	16	no	NA	NA
8137	scaffold_105	153362	153430	68	16	no	NA	NA
8138	scaffold_105	154325	154393	68	16	no	NA	NA
8139	scaffold_105	155287	155355	68	16	no	NA	NA
8140	scaffold_105	156249	156317	68	16	no	NA	NA
8141	scaffold_105	157213	157281	68	16	yes	400081	+
8142	scaffold_105	158211	158279	68	16	no	NA	NA
8143	scaffold_105	158808	158817	9	6	yes	302768	+
8144	scaffold_105	194455	195541	1086	114	yes	398513	-
8145	scaffold_239	12787	12825	38	6	no	NA	NA
8146	scaffold_296	6985	7625	640	84	no	NA	NA
8147	scaffold_50	12232	13215	983	54	yes	142079	-
8148	scaffold_50	13810	14749	939	84	no	NA	NA
8149	scaffold_50	26862	27646	784	87	yes	328133	+
8150	scaffold_50	35902	36952	1050	129	yes	328137	-
8151	scaffold_50	42393	43302	909	69	yes	415317	-
8152	scaffold_50	48374	49658	1284	108	yes	395756	-
8153	scaffold_50	97896	98481	585	58	yes	328161	-
8154	scaffold_50	107158	107170	12	4	no	NA	NA
8155	scaffold_50	109611	110918	1307	139	no	NA	NA
8156	scaffold_50	115737	116743	1006	117	yes	142235	-
8157	scaffold_50	116907	118255	1348	123	yes	142235,328163	-,-
8158	scaffold_50	119404	120778	1374	82	yes	222447	+
8159	scaffold_50	127438	128746	1308	108	yes	395771	-
8160	scaffold_50	130313	131318	1005	109	yes	247974	-
8161	scaffold_50	132269	133771	1502	178	yes	429225	+
8162	scaffold_50	141821	142241	420	51	no	NA	NA
8163	scaffold_50	144352	145555	1203	139	yes	328176	+
8164	scaffold_50	150320	151895	1575	213	yes	328181	-
8165	scaffold_50	152805	153717	912	109	yes	247982,328183	+,-
8166	scaffold_50	153929	154717	788	92	yes	247982,328183,328187	+,-,+
8167	scaffold_50	154848	155991	1143	117	yes	328187	+
8168	scaffold_50	157430	158355	925	121	yes	328192	-
8169	scaffold_50	171407	172365	958	119	yes	247990,328197	+,-
8170	scaffold_50	172664	173574	910	97	yes	247990,328197	+,-
8171	scaffold_50	177347	178572	1225	154	yes	222401	-
8172	scaffold_50	190292	191397	1105	111	yes	328200	+
8173	scaffold_50	199105	199156	51	6	no	NA	NA
8174	scaffold_50	199421	199724	303	23	yes	142503	-
8175	scaffold_50	204380	204928	548	38	yes	142506	-
8176	scaffold_50	208131	209304	1173	149	yes	415360	-
8177	scaffold_50	210504	211290	786	89	no	NA	NA
8178	scaffold_50	213149	214257	1108	109	yes	395789	-
8179	scaffold_50	215351	215889	538	41	yes	328212	+
8180	scaffold_50	215999	216236	237	28	no	NA	NA
8181	scaffold_50	217902	219159	1257	131	yes	328214	+
8182	scaffold_50	224130	225887	1757	182	yes	415365	+
8183	scaffold_50	230188	231671	1483	177	yes	429246	-
8184	scaffold_50	233970	234185	215	27	yes	142590	-
8185	scaffold_50	238845	239668	823	95	yes	142597	-
8186	scaffold_50	245362	246548	1186	107	yes	248003	-
8187	scaffold_50	248385	249696	1311	163	yes	328224,366213	+,-
8188	scaffold_50	249911	251293	1382	144	yes	328224	+
8189	scaffold_50	254728	255642	914	61	yes	142672	+
8190	scaffold_50	267664	268949	1285	138	yes	415375	-
8191	scaffold_50	274108	275311	1203	106	yes	415376	-
8192	scaffold_50	290896	291540	644	72	yes	385947	-
8193	scaffold_50	298771	300027	1256	183	yes	299235	-
8194	scaffold_50	323500	324471	971	118	yes	328258	+
8195	scaffold_50	329997	331109	1112	93	yes	328260	+
8196	scaffold_50	346363	347755	1392	168	yes	142840	-
8197	scaffold_50	348702	349911	1209	145	yes	429265	+
8198	scaffold_50	356734	357753	1019	83	yes	415395	-
8199	scaffold_50	360714	361461	747	108	yes	328268,328269	-,+
8200	scaffold_50	375438	375859	421	28	no	NA	NA
8201	scaffold_50	384983	385036	53	14	no	NA	NA
8202	scaffold_50	385124	386142	1018	140	yes	299252	-
8203	scaffold_50	390239	390848	609	56	yes	328277	+
8204	scaffold_50	405100	405746	646	78	no	NA	NA
8205	scaffold_50	420245	420280	35	6	no	NA	NA
8206	scaffold_50	420356	421740	1384	154	yes	415410	-
8207	scaffold_50	427418	428698	1280	158	yes	328284	+
8208	scaffold_50	450389	451812	1423	127	yes	328289	-
8209	scaffold_50	457748	457755	7	4	no	NA	NA
8210	scaffold_50	481134	481358	224	34	yes	328294	+
8211	scaffold_50	495906	496529	623	58	yes	429288	+
8212	scaffold_50	496814	496827	13	3	no	NA	NA
8213	scaffold_50	503177	504682	1505	154	yes	429289	-
8214	scaffold_50	507378	508767	1389	129	yes	395839	-
8215	scaffold_50	511922	512890	968	106	yes	328300	-
8216	scaffold_50	513338	514592	1254	153	yes	328302	-
8217	scaffold_50	518248	519438	1190	125	no	NA	NA
8218	scaffold_50	526293	528245	1952	134	yes	328307	-
8219	scaffold_50	529331	530526	1195	120	yes	143165	-
8220	scaffold_50	534274	534301	27	6	no	NA	NA
8221	scaffold_50	543496	543506	10	6	no	NA	NA
8222	scaffold_50	544420	544889	469	26	yes	328314	-
8223	scaffold_50	545354	546835	1481	155	yes	328314,395850	-,-
8224	scaffold_50	556691	556990	299	10	no	NA	NA
8225	scaffold_50	572869	574491	1622	174	yes	328321	-
8226	scaffold_50	577622	578225	603	70	no	NA	NA
8227	scaffold_50	592647	593180	533	72	no	NA	NA
8228	scaffold_187	10851	10926	75	20	no	NA	NA
8229	scaffold_187	11027	11074	47	13	no	NA	NA
8230	scaffold_187	11182	11204	22	8	no	NA	NA
8231	scaffold_187	20582	21381	799	82	no	NA	NA
8232	scaffold_242	10015	10136	121	14	no	NA	NA
8233	scaffold_242	11175	12636	1461	114	yes	82142	+
8234	scaffold_242	12712	12767	55	8	no	NA	NA
8235	scaffold_242	12877	12925	48	6	no	NA	NA
8236	scaffold_356	6489	7131	642	73	no	NA	NA
8237	scaffold_51	6118	6240	122	5	no	NA	NA
8238	scaffold_51	22187	22258	71	8	no	NA	NA
8239	scaffold_51	22547	23320	773	73	yes	328339	-
8240	scaffold_51	24268	27765	3497	344	yes	328343	-
8241	scaffold_51	31227	31989	762	97	yes	328349	+
8242	scaffold_51	32499	32549	50	7	no	NA	NA
8243	scaffold_51	34972	36187	1215	110	yes	395861	-
8244	scaffold_51	45773	47146	1373	130	yes	429312	-
8245	scaffold_51	49037	50061	1024	142	yes	328360	-
8246	scaffold_51	51938	53112	1174	155	yes	328361	-
8247	scaffold_51	55177	56761	1584	194	yes	429315	+
8248	scaffold_51	64052	65220	1168	100	yes	299305	+
8249	scaffold_51	74942	75710	768	69	yes	366223	+
8250	scaffold_51	84468	85204	736	67	yes	328380	+
8251	scaffold_51	86438	87172	734	92	no	NA	NA
8252	scaffold_51	91926	92792	866	120	yes	378530	-
8253	scaffold_51	95840	96662	822	102	no	NA	NA
8254	scaffold_51	98543	99212	669	63	no	NA	NA
8255	scaffold_51	99531	100154	623	64	yes	409744	+
8256	scaffold_51	104216	104454	238	16	yes	429322	-
8257	scaffold_51	120531	120892	361	39	yes	328390	-
8258	scaffold_51	156835	157359	524	62	yes	328400	-
8259	scaffold_51	182510	183672	1162	122	yes	328407	-
8260	scaffold_51	195048	195286	238	22	yes	328413	-
8261	scaffold_51	198229	199409	1180	164	yes	328416	-
8262	scaffold_51	213852	214362	510	27	no	NA	NA
8263	scaffold_51	221714	222269	555	69	yes	395897	-
8264	scaffold_51	229801	231138	1337	143	yes	222590	+
8265	scaffold_51	234272	235389	1117	132	yes	328424	-
8266	scaffold_51	236870	237024	154	22	no	NA	NA
8267	scaffold_51	237136	237149	13	4	no	NA	NA
8268	scaffold_51	245448	246865	1417	124	yes	143817	-
8269	scaffold_51	251577	252544	967	128	yes	222523	-
8270	scaffold_51	269609	270929	1320	148	yes	429352	-
8271	scaffold_51	273174	274304	1130	164	yes	328437	+
8272	scaffold_51	276511	276535	24	6	no	NA	NA
8273	scaffold_51	283866	285716	1850	164	no	NA	NA
8274	scaffold_51	298639	299571	932	123	yes	328441	+
8275	scaffold_51	309032	310039	1007	119	yes	328446	-
8276	scaffold_51	313692	314673	981	74	yes	299354	+
8277	scaffold_51	343170	343609	439	35	no	NA	NA
8278	scaffold_51	343737	344204	467	40	no	NA	NA
8279	scaffold_51	347732	349277	1545	126	yes	409792	-
8280	scaffold_51	353045	354176	1131	163	yes	328456	-
8281	scaffold_51	355239	356991	1752	170	yes	144003	+
8282	scaffold_51	361800	362893	1093	141	no	NA	NA
8283	scaffold_51	369776	371085	1309	99	yes	409799	+
8284	scaffold_51	398851	400007	1156	113	yes	328465	-
8285	scaffold_51	404972	405023	51	12	no	NA	NA
8286	scaffold_51	405170	406139	969	100	yes	235704	-
8287	scaffold_51	415915	417419	1504	192	no	NA	NA
8288	scaffold_51	420304	421541	1237	101	yes	429372	+
8289	scaffold_51	425506	426745	1239	122	yes	299375,328473	+,+
8290	scaffold_51	432147	433828	1681	202	yes	222587	+
8291	scaffold_51	436298	437845	1547	145	yes	328478	+
8292	scaffold_51	440321	442106	1785	161	yes	429376	-
8293	scaffold_51	447405	448755	1350	92	yes	429377	+
8294	scaffold_51	451685	452817	1132	143	yes	328484	-
8295	scaffold_51	454379	455059	680	80	yes	328487	+
8296	scaffold_51	456255	457487	1232	134	yes	366233	+
8297	scaffold_51	463402	464383	981	136	yes	395934	-
8298	scaffold_51	467782	469242	1460	176	yes	222545	+
8299	scaffold_51	474429	475636	1207	153	no	NA	NA
8300	scaffold_51	487346	487954	608	36	no	NA	NA
8301	scaffold_51	493977	495167	1190	98	yes	328514	-
8302	scaffold_51	497199	498041	842	112	yes	248117	-
8303	scaffold_51	500858	501227	369	38	no	NA	NA
8304	scaffold_51	503660	504415	755	76	yes	328520	-
8305	scaffold_51	507996	509384	1388	150	no	NA	NA
8306	scaffold_51	519470	520751	1281	119	yes	328531	-
8307	scaffold_51	525814	527433	1619	177	yes	409833	-
8308	scaffold_51	556730	558217	1487	131	yes	328551	+
8309	scaffold_51	569217	569983	766	46	no	NA	NA
8310	scaffold_51	579971	581639	1668	290	yes	328554	-
8311	scaffold_51	583179	583676	497	79	no	NA	NA
8312	scaffold_51	596392	597327	935	76	no	NA	NA
8313	scaffold_221	3024	3476	452	60	no	NA	NA
8314	scaffold_221	12016	12035	19	6	no	NA	NA
8315	scaffold_221	12504	12530	26	9	no	NA	NA
8316	scaffold_221	15667	15706	39	12	no	NA	NA
8317	scaffold_52	7601	8737	1136	138	yes	144738,429401	-,+
8318	scaffold_52	9230	11100	1870	259	yes	429401,222630	+,-
8319	scaffold_52	13624	15062	1438	153	no	NA	NA
8320	scaffold_52	16981	17946	965	150	yes	415816	-
8321	scaffold_52	18202	19639	1437	148	yes	415816,415817	-,+
8322	scaffold_52	40365	41333	968	45	yes	144888	+
8323	scaffold_52	41595	42256	661	40	yes	144888	+
8324	scaffold_52	61406	61987	581	76	no	NA	NA
8325	scaffold_52	62078	62507	429	48	yes	248153	-
8326	scaffold_52	69836	70614	778	34	yes	415827	-
8327	scaffold_52	72340	72353	13	6	no	NA	NA
8328	scaffold_52	83967	84002	35	8	no	NA	NA
8329	scaffold_52	84067	85319	1252	143	yes	328600,328603	-,+
8330	scaffold_52	85580	86050	470	40	yes	328600,328603	-,+
8331	scaffold_52	86166	86787	621	74	no	NA	NA
8332	scaffold_52	113540	114688	1148	166	yes	328619	+
8333	scaffold_52	118790	120322	1532	124	yes	328624	-
8334	scaffold_52	125602	126815	1213	143	yes	415841	-
8335	scaffold_52	127912	129159	1247	148	yes	328629	-
8336	scaffold_52	129429	130324	895	79	yes	328629	-
8337	scaffold_52	130572	132227	1655	183	yes	328631	-
8338	scaffold_52	143649	144782	1133	140	yes	328639	-
8339	scaffold_52	146208	146283	75	14	yes	235778	+
8340	scaffold_52	149130	150205	1075	144	yes	429429	-
8341	scaffold_52	160978	162138	1160	112	yes	328649	+
8342	scaffold_52	174577	175219	642	39	no	NA	NA
8343	scaffold_52	175869	176338	469	51	yes	299453	+
8344	scaffold_52	186948	186952	4	4	yes	328663	-
8345	scaffold_52	193077	194460	1383	211	yes	328667	+
8346	scaffold_52	201449	202464	1015	86	yes	328670	-
8347	scaffold_52	226954	228398	1444	168	yes	235784	+
8348	scaffold_52	237264	237270	6	4	no	NA	NA
8349	scaffold_52	237527	238663	1136	54	yes	145387	-
8350	scaffold_52	245000	245944	944	87	yes	429440	-
8351	scaffold_52	251154	252055	901	81	yes	429441	-
8352	scaffold_52	257834	258614	780	72	no	NA	NA
8353	scaffold_52	263893	265242	1349	185	yes	328688	-
8354	scaffold_52	266653	267768	1115	150	yes	328691	-
8355	scaffold_52	271245	272204	959	85	yes	328694	+
8356	scaffold_52	272353	273645	1292	169	yes	328694	+
8357	scaffold_52	274395	275704	1309	163	yes	385977	+
8358	scaffold_52	282268	283373	1105	125	yes	378680,429448	+,-
8359	scaffold_52	283670	284723	1053	117	yes	415875,429449	-,+
8360	scaffold_52	300067	300981	914	118	yes	328734	-
8361	scaffold_52	302427	303586	1159	110	yes	222644	+
8362	scaffold_52	310056	311162	1106	80	yes	415890	-
8363	scaffold_52	313551	314074	523	29	yes	328750	+
8364	scaffold_52	314266	314490	224	16	yes	145656	+
8365	scaffold_52	314867	316479	1612	173	yes	145656,328753	+,+
8366	scaffold_52	318673	319662	989	97	yes	328755	+
8367	scaffold_52	321222	322333	1111	119	yes	328758	+
8368	scaffold_52	327790	330844	3054	311	yes	328762,328763	+,-
8369	scaffold_52	338002	338163	161	12	yes	415898	-
8370	scaffold_52	338377	338742	365	34	yes	415898	-
8371	scaffold_52	339620	340197	577	45	yes	328767	+
8372	scaffold_52	345687	346903	1216	120	yes	299490	+
8373	scaffold_52	350751	351478	727	83	yes	328773	+
8374	scaffold_52	357276	358311	1035	91	yes	328777	+
8375	scaffold_52	366732	368080	1348	130	no	NA	NA
8376	scaffold_52	377913	377940	27	8	no	NA	NA
8377	scaffold_52	378881	378904	23	4	yes	328789	-
8378	scaffold_52	397204	399484	2280	252	yes	328795,328797	-,+
8379	scaffold_52	399714	400668	954	139	yes	328795,328797	-,+
8380	scaffold_52	406990	407444	454	43	yes	328799	-
8381	scaffold_52	408552	409523	971	141	no	NA	NA
8382	scaffold_52	410116	410991	875	61	yes	248215	-
8383	scaffold_52	415423	416109	686	48	yes	328816	+
8384	scaffold_52	448397	449066	669	56	yes	328843	-
8385	scaffold_52	453279	453500	221	13	yes	328847	-
8386	scaffold_52	478998	479042	44	4	no	NA	NA
8387	scaffold_52	479416	480262	846	70	yes	248236	-
8388	scaffold_52	484218	485571	1353	185	yes	328862	+
8389	scaffold_52	485706	485809	103	16	no	NA	NA
8390	scaffold_52	507686	508849	1163	139	yes	328868,378726	+,-
8391	scaffold_52	509018	510268	1250	151	yes	328868,378726	+,-
8392	scaffold_52	549912	550907	995	115	yes	222691	-
8393	scaffold_52	560029	561168	1139	121	yes	429515	-
8394	scaffold_52	564987	565632	645	72	yes	328890	+
8395	scaffold_52	570834	570843	9	4	yes	429517	-
8396	scaffold_104	6997	7933	936	116	yes	431993	-
8397	scaffold_104	12375	13609	1234	133	yes	225191	-
8398	scaffold_104	17771	19278	1507	169	yes	334749	+
8399	scaffold_104	19740	20865	1125	117	yes	366521	+
8400	scaffold_104	52691	53826	1135	77	yes	334759	-
8401	scaffold_104	55436	56831	1395	158	yes	334761	+
8402	scaffold_104	61742	62866	1124	100	yes	334764	-
8403	scaffold_104	64560	66126	1566	156	yes	334767	+
8404	scaffold_104	66363	67515	1152	128	no	NA	NA
8405	scaffold_104	71793	71799	6	4	yes	21081	-
8406	scaffold_104	72154	72552	398	19	yes	21081	-
8407	scaffold_104	90342	91523	1181	117	yes	398468	-
8408	scaffold_104	94800	96020	1220	109	yes	334775	+
8409	scaffold_104	100535	101522	987	87	yes	225226,334777	+,-
8410	scaffold_104	101657	103507	1850	234	yes	225226,334777,415560	+,-,+
8411	scaffold_104	105059	105106	47	10	no	NA	NA
8412	scaffold_104	109719	109953	234	26	yes	334784	+
8413	scaffold_104	111975	112407	432	34	yes	334788	-
8414	scaffold_104	118620	120025	1405	152	no	NA	NA
8415	scaffold_104	120212	121135	923	107	no	NA	NA
8416	scaffold_104	131286	131322	36	9	yes	415567	+
8417	scaffold_104	138170	139287	1117	130	yes	334804	-
8418	scaffold_104	140292	142232	1940	218	yes	334806	+
8419	scaffold_104	144157	145749	1592	154	yes	432019	+
8420	scaffold_104	152828	153966	1138	133	yes	334808	+
8421	scaffold_104	155852	156883	1031	79	yes	334810	+
8422	scaffold_104	160911	162399	1488	235	yes	334812	-
8423	scaffold_104	175951	176571	620	33	no	NA	NA
8424	scaffold_104	179685	180080	395	33	no	NA	NA
8425	scaffold_104	180443	182082	1639	176	yes	21297	+
8426	scaffold_104	182203	182210	7	3	no	NA	NA
8427	scaffold_104	192462	193999	1537	172	yes	415576	-
8428	scaffold_104	194617	195792	1175	85	yes	334827	+
8429	scaffold_104	199810	200530	720	46	yes	334830	-
8430	scaffold_104	205758	207141	1383	128	yes	238071	-
8431	scaffold_183	9740	9768	28	7	no	NA	NA
8432	scaffold_295	2648	3288	640	75	no	NA	NA
8433	scaffold_295	10160	10537	377	35	no	NA	NA
8434	scaffold_53	11966	12859	893	77	yes	146504	-
8435	scaffold_53	26283	27183	900	77	yes	328908	-
8436	scaffold_53	27679	27706	27	8	no	NA	NA
8437	scaffold_53	33428	34877	1449	123	yes	146537	+
8438	scaffold_53	41349	42838	1489	168	yes	396074	-
8439	scaffold_53	46366	46949	583	49	yes	328919	+
8440	scaffold_53	47106	47111	5	3	no	NA	NA
8441	scaffold_53	54501	55646	1145	157	yes	396076	+
8442	scaffold_53	71396	72302	906	57	yes	328930	-
8443	scaffold_53	81491	81957	466	29	yes	396080	+
8444	scaffold_53	86496	87516	1020	93	yes	328933	-
8445	scaffold_53	89662	90718	1056	112	yes	146640	-
8446	scaffold_53	92504	93602	1098	88	no	NA	NA
8447	scaffold_53	96265	97120	855	82	yes	328938	+
8448	scaffold_53	98475	99236	761	90	yes	328939	+
8449	scaffold_53	101015	102096	1081	75	yes	429541	-
8450	scaffold_53	118814	119950	1136	126	yes	429547	+
8451	scaffold_53	129279	129318	39	12	no	NA	NA
8452	scaffold_53	129570	129753	183	19	no	NA	NA
8453	scaffold_53	129854	130039	185	24	no	NA	NA
8454	scaffold_53	133447	133617	170	14	no	NA	NA
8455	scaffold_53	133756	133794	38	12	no	NA	NA
8456	scaffold_53	133909	133920	11	6	no	NA	NA
8457	scaffold_53	160584	161159	575	71	no	NA	NA
8458	scaffold_53	161400	161747	347	36	no	NA	NA
8459	scaffold_53	169878	169921	43	14	no	NA	NA
8460	scaffold_53	170414	170734	320	33	no	NA	NA
8461	scaffold_53	173099	174586	1487	154	yes	328953	+
8462	scaffold_53	180954	181905	951	80	yes	328955	-
8463	scaffold_53	182015	182072	57	12	yes	328955	-
8464	scaffold_53	184083	185459	1376	123	yes	146797	+
8465	scaffold_53	189544	190304	760	92	yes	328959	+
8466	scaffold_53	206606	207984	1378	120	no	NA	NA
8467	scaffold_53	209849	211174	1325	149	yes	429561	+
8468	scaffold_53	229312	230648	1336	148	yes	328970	+
8469	scaffold_53	239881	241136	1255	166	yes	396112	-
8470	scaffold_53	245040	246339	1299	130	yes	328980	+
8471	scaffold_53	248471	249511	1040	124	yes	328983	-
8472	scaffold_53	265338	266617	1279	141	yes	328989	+
8473	scaffold_53	276199	277385	1186	118	yes	328993	-
8474	scaffold_53	278051	279277	1226	143	yes	328994	+
8475	scaffold_53	285009	285791	782	49	yes	328999	+
8476	scaffold_53	289458	290652	1194	156	yes	385994	+
8477	scaffold_53	296892	296905	13	6	yes	429576	-
8478	scaffold_53	297554	298894	1340	138	yes	329007	+
8479	scaffold_53	301887	303035	1148	119	yes	248309,329015	-,+
8480	scaffold_53	306152	307318	1166	157	yes	299615	+
8481	scaffold_53	312254	313923	1669	207	yes	329021	-
8482	scaffold_53	314639	315590	951	126	yes	222841	+
8483	scaffold_53	323792	323811	19	4	no	NA	NA
8484	scaffold_53	323906	325115	1209	187	no	NA	NA
8485	scaffold_53	325566	326923	1357	131	yes	299620	+
8486	scaffold_53	334653	335792	1139	100	yes	222813,235923	+,-
8487	scaffold_53	336061	338228	2167	260	yes	222813	+
8488	scaffold_53	338669	339978	1309	169	yes	366273	+
8489	scaffold_53	342098	343225	1127	130	yes	147560	-
8490	scaffold_53	344193	345100	907	89	yes	147555	-
8491	scaffold_53	351045	351827	782	96	yes	429589	-
8492	scaffold_53	351966	352151	185	12	no	NA	NA
8493	scaffold_53	370030	371782	1752	108	yes	396141	+
8494	scaffold_53	371903	372020	117	8	yes	396141	+
8495	scaffold_53	382229	383709	1480	177	no	NA	NA
8496	scaffold_53	395866	396977	1111	148	yes	329062	-
8497	scaffold_53	400019	400837	818	72	yes	329063	-
8498	scaffold_53	403735	404845	1110	92	yes	410642	-
8499	scaffold_53	418626	419297	671	74	yes	329068	-
8500	scaffold_53	420782	421490	708	79	yes	429599	+
8501	scaffold_53	422610	424231	1621	169	yes	329072	+
8502	scaffold_53	431536	432725	1189	112	yes	366274	-
8503	scaffold_53	436781	437950	1169	123	yes	329076	+
8504	scaffold_53	482336	483860	1524	124	no	NA	NA
8505	scaffold_53	490131	491069	938	82	yes	329083	-
8506	scaffold_53	494181	494200	19	6	no	NA	NA
8507	scaffold_53	494305	495313	1008	138	yes	299657	-
8508	scaffold_53	512434	513536	1102	154	yes	248334	+
8509	scaffold_53	520712	522253	1541	190	yes	299664	-
8510	scaffold_53	527168	527245	77	6	no	NA	NA
8511	scaffold_53	527359	528529	1170	145	yes	329103	-
8512	scaffold_53	529119	530564	1445	165	yes	329103,329106	-,+
8513	scaffold_53	532863	533595	732	104	yes	329112	+
8514	scaffold_53	533790	534596	806	98	yes	329112	+
8515	scaffold_53	540353	541800	1447	159	yes	329114	+
8516	scaffold_53	545708	546576	868	119	yes	329116	-
8517	scaffold_53	547185	547215	30	4	yes	329117	+
8518	scaffold_53	547347	547940	593	65	yes	329117	+
8519	scaffold_53	550916	552247	1331	128	yes	299675	+
8520	scaffold_53	552362	552382	20	6	yes	299675	+
8521	scaffold_53	557064	557077	13	4	no	NA	NA
8522	scaffold_53	565108	566452	1344	122	yes	329130	-
8523	scaffold_53	568123	569405	1282	148	no	NA	NA
8524	scaffold_53	576773	578383	1610	158	yes	299678,329132	+,+
8525	scaffold_103	37353	37796	443	38	yes	334683	-
8526	scaffold_103	37895	37957	62	8	yes	334683	-
8527	scaffold_103	44395	45232	837	86	yes	398442	+
8528	scaffold_103	56871	56903	32	8	no	NA	NA
8529	scaffold_103	57086	57372	286	22	yes	302674	-
8530	scaffold_103	57476	57686	210	24	yes	302674	-
8531	scaffold_103	70244	70839	595	74	no	NA	NA
8532	scaffold_103	71149	71961	812	71	yes	250348	-
8533	scaffold_103	82769	82782	13	3	yes	431980	-
8534	scaffold_103	82972	82980	8	4	yes	431980	-
8535	scaffold_103	88426	89214	788	90	no	NA	NA
8536	scaffold_103	93233	93696	463	59	yes	398446	-
8537	scaffold_103	116429	116605	176	11	no	NA	NA
8538	scaffold_103	120283	120383	100	23	no	NA	NA
8539	scaffold_103	121177	121244	67	16	no	NA	NA
8540	scaffold_103	122112	122172	60	12	no	NA	NA
8541	scaffold_103	123332	123437	105	16	no	NA	NA
8542	scaffold_103	124355	124422	67	16	no	NA	NA
8543	scaffold_103	125310	125370	60	15	no	NA	NA
8544	scaffold_103	126530	126551	21	8	yes	413493	+
8545	scaffold_103	127837	127904	67	14	no	NA	NA
8546	scaffold_103	128792	128813	21	8	no	NA	NA
8547	scaffold_103	130012	130072	60	16	yes	413494	+
8548	scaffold_103	131014	131102	88	20	no	NA	NA
8549	scaffold_103	131990	132050	60	18	no	NA	NA
8550	scaffold_103	133210	133277	67	16	no	NA	NA
8551	scaffold_103	139141	139159	18	6	no	NA	NA
8552	scaffold_103	140065	140132	67	15	yes	413497	+
8553	scaffold_103	140979	141046	67	16	no	NA	NA
8554	scaffold_103	141893	141960	67	16	no	NA	NA
8555	scaffold_103	143042	143103	61	14	no	NA	NA
8556	scaffold_103	144727	144794	67	15	no	NA	NA
8557	scaffold_103	208579	208609	30	10	no	NA	NA
8558	scaffold_103	208736	208751	15	4	no	NA	NA
8559	scaffold_103	208918	208924	6	4	no	NA	NA
8560	scaffold_103	209002	209027	25	4	no	NA	NA
8561	scaffold_103	212440	212665	225	26	yes	302697	-
8562	scaffold_103	212773	212836	63	11	yes	302697	-
8563	scaffold_103	212977	213025	48	6	yes	302697	-
8564	scaffold_103	213703	213724	21	8	no	NA	NA
8565	scaffold_103	214102	214180	78	12	no	NA	NA
8566	scaffold_169	2715	2734	19	7	no	NA	NA
8567	scaffold_169	21974	22474	500	70	no	NA	NA
8568	scaffold_169	27206	27975	769	72	no	NA	NA
8569	scaffold_54	15520	16290	770	87	no	NA	NA
8570	scaffold_54	17274	18049	775	80	no	NA	NA
8571	scaffold_54	20019	20190	171	12	no	NA	NA
8572	scaffold_54	20700	20748	48	8	no	NA	NA
8573	scaffold_54	20818	21424	606	74	yes	329136	-
8574	scaffold_54	27114	28437	1323	154	no	NA	NA
8575	scaffold_54	101090	102653	1563	185	yes	429642	-
8576	scaffold_54	160717	162425	1708	213	yes	329190	-
8577	scaffold_54	172912	173666	754	46	yes	378979	-
8578	scaffold_54	173917	174826	909	87	yes	378979	-
8579	scaffold_54	209879	211100	1221	154	yes	299717	-
8580	scaffold_54	220717	221752	1035	113	no	NA	NA
8581	scaffold_54	226965	228495	1530	149	no	NA	NA
8582	scaffold_54	228676	229524	848	86	yes	329209	-
8583	scaffold_54	241851	243412	1561	177	no	NA	NA
8584	scaffold_54	246011	246450	439	55	no	NA	NA
8585	scaffold_54	250930	252101	1171	167	no	NA	NA
8586	scaffold_54	323525	325414	1889	211	yes	148455	+
8587	scaffold_54	350623	351009	386	38	yes	418340	+
8588	scaffold_54	352356	352524	168	27	yes	299740	+
8589	scaffold_54	352627	352704	77	12	yes	299740	+
8590	scaffold_54	367203	367812	609	59	no	NA	NA
8591	scaffold_54	375906	376680	774	70	no	NA	NA
8592	scaffold_54	378278	379328	1050	126	yes	429683	+
8593	scaffold_54	409071	409076	5	4	yes	248396	-
8594	scaffold_54	409188	409259	71	14	no	NA	NA
8595	scaffold_54	413878	413956	78	14	yes	299752	+
8596	scaffold_54	414062	414437	375	33	yes	299752	+
8597	scaffold_54	414590	414602	12	4	no	NA	NA
8598	scaffold_54	432588	433833	1245	130	yes	429687	+
8599	scaffold_54	448182	448351	169	22	yes	299756	-
8600	scaffold_54	456285	456299	14	6	no	NA	NA
8601	scaffold_54	491805	492126	321	20	yes	396234	+
8602	scaffold_54	492284	492300	16	4	no	NA	NA
8603	scaffold_54	492437	492450	13	6	no	NA	NA
8604	scaffold_54	492636	492645	9	6	no	NA	NA
8605	scaffold_54	495179	495188	9	4	yes	396235	-
8606	scaffold_54	500347	501336	989	130	yes	429693	+
8607	scaffold_54	501456	501486	30	6	no	NA	NA
8608	scaffold_54	520334	520439	105	20	yes	429695	+
8609	scaffold_54	520649	520695	46	14	yes	429695	+
8610	scaffold_54	520838	520867	29	10	no	NA	NA
8611	scaffold_54	520995	521047	52	16	no	NA	NA
8612	scaffold_54	525890	525910	20	6	yes	429696	+
8613	scaffold_54	526022	526073	51	12	yes	429696	+
8614	scaffold_54	526235	526662	427	57	no	NA	NA
8615	scaffold_54	529691	529736	45	7	no	NA	NA
8616	scaffold_54	531426	531446	20	6	yes	396238	+
8617	scaffold_54	531575	532200	625	71	yes	396238	+
8618	scaffold_54	539607	540038	431	51	yes	429698	+
8619	scaffold_54	540162	540215	53	14	no	NA	NA
8620	scaffold_54	540306	540598	292	35	no	NA	NA
8621	scaffold_54	546582	547558	976	96	no	NA	NA
8622	scaffold_54	548025	548723	698	56	yes	236008	+
8623	scaffold_54	550681	550739	58	16	no	NA	NA
8624	scaffold_54	552052	552806	754	85	no	NA	NA
8625	scaffold_54	553465	554187	722	61	no	NA	NA
8626	scaffold_204	8874	8913	39	12	no	NA	NA
8627	scaffold_204	12275	12294	19	7	no	NA	NA
8628	scaffold_204	12771	12785	14	6	no	NA	NA
8629	scaffold_55	4866	4880	14	6	yes	299774	+
8630	scaffold_55	7322	9171	1849	222	yes	396243	+
8631	scaffold_55	10486	11377	891	78	yes	148877	-
8632	scaffold_55	23631	24046	415	36	yes	329302	+
8633	scaffold_55	43173	43795	622	73	yes	396251	+
8634	scaffold_55	78138	78356	218	23	no	NA	NA
8635	scaffold_55	88857	89060	203	10	no	NA	NA
8636	scaffold_55	89153	89782	629	45	no	NA	NA
8637	scaffold_55	91294	91765	471	40	no	NA	NA
8638	scaffold_55	92024	92089	65	9	yes	149019	-
8639	scaffold_55	92231	92251	20	6	yes	149019	-
8640	scaffold_55	101379	101418	39	4	yes	299798	-
8641	scaffold_55	112268	113472	1204	137	yes	411716,429718	+,-
8642	scaffold_55	128704	128759	55	20	yes	411719	-
8643	scaffold_55	132387	133493	1106	97	yes	429720	-
8644	scaffold_55	136369	137342	973	98	yes	396259	-
8645	scaffold_55	140504	140510	6	4	no	NA	NA
8646	scaffold_55	140704	140928	224	28	yes	429722	-
8647	scaffold_55	144121	144130	9	4	no	NA	NA
8648	scaffold_55	144834	144889	55	20	yes	379089	-
8649	scaffold_55	145306	145320	14	6	yes	379089	-
8650	scaffold_55	148717	148787	70	18	no	NA	NA
8651	scaffold_55	148917	149133	216	16	yes	149083	-
8652	scaffold_55	155268	155299	31	6	no	NA	NA
8653	scaffold_55	243324	245491	2167	250	yes	329353	+
8654	scaffold_55	248766	248772	6	4	no	NA	NA
8655	scaffold_55	283975	284034	59	10	no	NA	NA
8656	scaffold_55	311178	311235	57	8	yes	149226	-
8657	scaffold_55	311433	311439	6	4	yes	149226	-
8658	scaffold_55	333197	333282	85	15	yes	149248	-
8659	scaffold_55	335710	335738	28	4	no	NA	NA
8660	scaffold_55	335896	336184	288	8	no	NA	NA
8661	scaffold_55	336262	336307	45	10	no	NA	NA
8662	scaffold_55	343886	344094	208	17	yes	396281	-
8663	scaffold_55	355675	355734	59	14	no	NA	NA
8664	scaffold_55	369234	369276	42	12	yes	411773	+
8665	scaffold_55	369445	369454	9	3	yes	411773	+
8666	scaffold_55	369727	369959	232	15	no	NA	NA
8667	scaffold_55	417002	417047	45	10	no	NA	NA
8668	scaffold_55	417567	417605	38	10	no	NA	NA
8669	scaffold_55	446187	446208	21	8	yes	379149	-
8670	scaffold_55	446488	446535	47	9	yes	379149	-
8671	scaffold_55	485122	485191	69	20	no	NA	NA
8672	scaffold_55	487319	487340	21	8	no	NA	NA
8673	scaffold_55	489187	489255	68	20	no	NA	NA
8674	scaffold_55	490168	490236	68	17	no	NA	NA
8675	scaffold_55	491377	491429	52	9	yes	411798	+
8676	scaffold_55	493644	493711	67	16	no	NA	NA
8677	scaffold_55	495438	495459	21	8	yes	411799	+
8678	scaffold_55	496554	496621	67	13	no	NA	NA
8679	scaffold_55	497904	497938	34	7	yes	411801	+
8680	scaffold_55	502417	502438	21	8	no	NA	NA
8681	scaffold_102	3842	3858	16	4	no	NA	NA
8682	scaffold_102	8192	8210	18	6	yes	334648	+
8683	scaffold_102	32812	32829	17	6	no	NA	NA
8684	scaffold_102	40269	40279	10	4	no	NA	NA
8685	scaffold_102	44006	45435	1429	211	no	NA	NA
8686	scaffold_102	46544	47868	1324	143	yes	409546	+
8687	scaffold_102	48033	48048	15	4	no	NA	NA
8688	scaffold_102	67800	68315	515	48	no	NA	NA
8689	scaffold_102	75819	75862	43	12	no	NA	NA
8690	scaffold_102	78625	78653	28	8	no	NA	NA
8691	scaffold_102	81580	81733	153	21	no	NA	NA
8692	scaffold_102	86420	86450	30	4	no	NA	NA
8693	scaffold_102	86575	88740	2165	215	no	NA	NA
8694	scaffold_102	153918	155900	1982	200	no	NA	NA
8695	scaffold_102	184613	184622	9	4	no	NA	NA
8696	scaffold_144	9579	9617	38	10	no	NA	NA
8697	scaffold_144	13127	13941	814	83	yes	303521	+
8698	scaffold_144	20097	20123	26	8	yes	399540	+
8699	scaffold_144	38078	39404	1326	152	yes	399553	-
8700	scaffold_144	47209	47466	257	25	yes	432659	-
8701	scaffold_189	13227	13246	19	6	no	NA	NA
8702	scaffold_189	16580	16619	39	12	no	NA	NA
8703	scaffold_189	19329	19347	18	8	no	NA	NA
8704	scaffold_189	19825	19843	18	6	no	NA	NA
8705	scaffold_240	2198	2412	214	31	no	NA	NA
8706	scaffold_240	2512	2560	48	14	no	NA	NA
8707	scaffold_240	2668	2690	22	8	no	NA	NA
8708	scaffold_56	8002	8306	304	39	yes	329461	+
8709	scaffold_56	12057	12919	862	85	yes	329462	+
8710	scaffold_56	13130	13148	18	6	no	NA	NA
8711	scaffold_56	29564	29578	14	6	no	NA	NA
8712	scaffold_56	82964	83426	462	68	yes	396304	+
8713	scaffold_56	102398	102585	187	21	yes	396307	-
8714	scaffold_56	152882	152891	9	4	yes	299892	-
8715	scaffold_56	161144	161227	83	26	no	NA	NA
8716	scaffold_56	175022	175893	871	106	no	NA	NA
8717	scaffold_56	176231	176721	490	34	yes	429777	-
8718	scaffold_56	235980	236739	759	101	no	NA	NA
8719	scaffold_56	283495	283962	467	51	yes	329512	-
8720	scaffold_56	290466	290955	489	39	yes	248449	-
8721	scaffold_56	303828	305673	1845	205	yes	329527	+
8722	scaffold_56	306775	308248	1473	207	yes	299927	+
8723	scaffold_56	311129	312689	1560	153	yes	149776	+
8724	scaffold_56	330397	330996	599	54	yes	329536	+
8725	scaffold_56	331177	331491	314	34	yes	329536	+
8726	scaffold_56	338387	339849	1462	125	yes	396332	-
8727	scaffold_56	340084	341799	1715	161	yes	396332,149828	-,+
8728	scaffold_56	376403	377693	1290	154	yes	329557	+
8729	scaffold_56	377939	377946	7	4	no	NA	NA
8730	scaffold_56	413942	415232	1290	114	yes	396339	-
8731	scaffold_56	424302	424925	623	62	yes	329564,396341	-,+
8732	scaffold_56	425073	426222	1149	149	yes	329564,396341	-,+
8733	scaffold_56	427922	428945	1023	104	no	NA	NA
8734	scaffold_56	434273	435506	1233	119	yes	415065	-
8735	scaffold_56	440154	440478	324	42	yes	396344	-
8736	scaffold_56	446806	447417	611	28	yes	299946	+
8737	scaffold_56	451626	451687	61	8	no	NA	NA
8738	scaffold_56	469649	470164	515	49	no	NA	NA
8739	scaffold_56	478641	478656	15	6	no	NA	NA
8740	scaffold_56	478889	479901	1012	132	no	NA	NA
8741	scaffold_56	485210	486467	1257	144	yes	150049,248461	+,+
8742	scaffold_56	499628	500446	818	106	no	NA	NA
8743	scaffold_56	509903	511270	1367	139	yes	329594,396352	+,-
8744	scaffold_56	511733	512472	739	52	yes	329594	+
8745	scaffold_56	515571	515577	6	4	yes	329595	-
8746	scaffold_56	517265	518073	808	73	yes	329598	-
8747	scaffold_101	15162	15174	12	3	yes	431915,431916	-,+
8748	scaffold_101	17668	18980	1312	148	no	NA	NA
8749	scaffold_101	19490	20631	1141	162	yes	415708,415709	+,+
8750	scaffold_101	20796	20803	7	4	yes	415709	+
8751	scaffold_101	29862	30616	754	84	no	NA	NA
8752	scaffold_101	39002	39718	716	64	yes	334585	-
8753	scaffold_101	46531	47401	870	92	yes	19799	-
8754	scaffold_101	50474	51807	1333	139	yes	334590	+
8755	scaffold_101	52047	52063	16	4	no	NA	NA
8756	scaffold_101	55221	56110	889	100	yes	334594	+
8757	scaffold_101	68334	69199	865	97	yes	302607,302608	-,-
8758	scaffold_101	70663	71250	587	64	yes	334604	-
8759	scaffold_101	81161	82525	1364	159	yes	302612,415726,415728	+,-,+
8760	scaffold_101	117768	119224	1456	183	yes	225153	-
8761	scaffold_101	128637	130059	1422	125	yes	334630	+
8762	scaffold_101	146787	148150	1363	113	no	NA	NA
8763	scaffold_101	209218	210221	1003	130	no	NA	NA
8764	scaffold_101	215699	216926	1227	194	yes	20094	-
8765	scaffold_101	218102	219392	1290	123	yes	334643	-
8766	scaffold_486	2039	2089	50	11	yes	407582	+
8767	scaffold_57	3857	3863	6	4	yes	329601	-
8768	scaffold_57	5552	5617	65	4	no	NA	NA
8769	scaffold_57	5731	6361	630	74	yes	329603	-
8770	scaffold_57	8864	9766	902	73	yes	150099	+
8771	scaffold_57	9885	9894	9	4	no	NA	NA
8772	scaffold_57	15645	16970	1325	136	yes	329610,429830	+,-
8773	scaffold_57	17158	18000	842	124	yes	329610,429830	+,-
8774	scaffold_57	25759	27238	1479	155	yes	400726	-
8775	scaffold_57	30936	32291	1355	162	yes	150215	+
8776	scaffold_57	32480	33516	1036	127	yes	150215	+
8777	scaffold_57	38008	39260	1252	160	yes	429836	-
8778	scaffold_57	46020	47497	1477	201	yes	223069	+
8779	scaffold_57	56329	57267	938	95	yes	400735	+
8780	scaffold_57	68104	69406	1302	132	yes	299977	-
8781	scaffold_57	70638	71959	1321	155	yes	329627	+
8782	scaffold_57	81718	82764	1046	60	yes	329635	-
8783	scaffold_57	86433	86479	46	12	no	NA	NA
8784	scaffold_57	86568	87021	453	54	yes	329638	+
8785	scaffold_57	87409	88564	1155	140	yes	329638	+
8786	scaffold_57	96443	96652	209	20	yes	400741	-
8787	scaffold_57	106145	106353	208	15	yes	396375	+
8788	scaffold_57	110066	110350	284	24	yes	429846	+
8789	scaffold_57	110489	110554	65	7	yes	429846	+
8790	scaffold_57	113336	114855	1519	211	yes	329651	-
8791	scaffold_57	121417	121867	450	49	yes	429849	-
8792	scaffold_57	123775	124121	346	43	yes	429850	-
8793	scaffold_57	125909	126395	486	49	no	NA	NA
8794	scaffold_57	128393	128724	331	46	yes	429851	-
8795	scaffold_57	136453	136705	252	31	no	NA	NA
8796	scaffold_57	138162	138290	128	6	no	NA	NA
8797	scaffold_57	138481	138971	490	64	no	NA	NA
8798	scaffold_57	140422	140769	347	49	yes	429854	-
8799	scaffold_57	147864	148410	546	49	yes	300002	-
8800	scaffold_57	149888	150153	265	40	yes	400761	-
8801	scaffold_57	156159	156197	38	7	yes	400763	-
8802	scaffold_57	163357	164185	828	77	yes	329668	-
8803	scaffold_57	186239	187357	1118	76	yes	223048	+
8804	scaffold_57	192490	193392	902	116	yes	150742	+
8805	scaffold_57	207018	207782	764	96	yes	150809,329689	-,+
8806	scaffold_57	224747	225950	1203	164	yes	150836,150849	-,-
8807	scaffold_57	229123	229602	479	46	no	NA	NA
8808	scaffold_57	231911	232522	611	63	yes	300016	+
8809	scaffold_57	234838	234850	12	6	no	NA	NA
8810	scaffold_57	236974	238261	1287	159	yes	400776	+
8811	scaffold_57	261575	261847	272	20	yes	223065	-
8812	scaffold_57	302651	303696	1045	106	no	NA	NA
8813	scaffold_57	304004	305025	1021	70	yes	429882	+
8814	scaffold_57	311769	312154	385	44	yes	396411	-
8815	scaffold_57	321046	321707	661	33	yes	329723	+
8816	scaffold_57	324423	325734	1311	113	yes	329732	+
8817	scaffold_57	332600	333969	1369	106	yes	300034	-
8818	scaffold_57	337573	338367	794	69	yes	396416	+
8819	scaffold_57	341040	341881	841	103	yes	400796	+
8820	scaffold_57	359591	360962	1371	162	yes	396419	-
8821	scaffold_57	362893	364029	1136	151	yes	329754	-
8822	scaffold_57	430455	432886	2431	255	yes	151268	+
8823	scaffold_57	435820	436163	343	25	yes	248536	+
8824	scaffold_57	442112	443483	1371	112	yes	396429	+
8825	scaffold_57	456469	457656	1187	132	yes	151295	+
8826	scaffold_57	469818	470637	819	62	yes	223039	-
8827	scaffold_57	485992	486743	751	95	yes	248540	-
8828	scaffold_57	498584	499146	562	41	no	NA	NA
8829	scaffold_57	510304	511515	1211	116	yes	223099	+
8830	scaffold_57	516492	516534	42	13	no	NA	NA
8831	scaffold_57	520163	520181	18	5	no	NA	NA
8832	scaffold_100	24352	24405	53	12	yes	401539	-
8833	scaffold_100	24735	25258	523	70	yes	401539	-
8834	scaffold_100	25928	25987	59	12	no	NA	NA
8835	scaffold_100	33151	33159	8	4	no	NA	NA
8836	scaffold_100	38555	39297	742	92	no	NA	NA
8837	scaffold_100	39495	39546	51	12	no	NA	NA
8838	scaffold_100	40078	40311	233	34	no	NA	NA
8839	scaffold_100	47438	47446	8	4	no	NA	NA
8840	scaffold_100	50005	50019	14	4	no	NA	NA
8841	scaffold_100	53168	53235	67	16	yes	431890	-
8842	scaffold_100	60259	60700	441	56	no	NA	NA
8843	scaffold_100	67288	67344	56	8	no	NA	NA
8844	scaffold_100	76248	77155	907	95	yes	401554	-
8845	scaffold_100	79037	79578	541	44	no	NA	NA
8846	scaffold_100	102299	102519	220	28	no	NA	NA
8847	scaffold_100	142714	142746	32	4	yes	334546	-
8848	scaffold_100	148594	148606	12	6	no	NA	NA
8849	scaffold_100	151176	151761	585	65	yes	398380	-
8850	scaffold_100	171388	171958	570	36	yes	431904	+
8851	scaffold_100	172031	172487	456	52	yes	431904	+
8852	scaffold_100	172694	172703	9	4	no	NA	NA
8853	scaffold_100	192990	193004	14	3	yes	431910	+
8854	scaffold_100	203813	204203	390	46	no	NA	NA
8855	scaffold_143	31502	31508	6	4	no	NA	NA
8856	scaffold_143	31620	31709	89	19	no	NA	NA
8857	scaffold_143	31950	32131	181	23	no	NA	NA
8858	scaffold_143	32272	32281	9	4	no	NA	NA
8859	scaffold_143	32571	32752	181	24	no	NA	NA
8860	scaffold_143	32893	32902	9	4	no	NA	NA
8861	scaffold_143	33138	33163	25	8	no	NA	NA
8862	scaffold_143	58688	58735	47	8	no	NA	NA
8863	scaffold_188	13469	13488	19	6	no	NA	NA
8864	scaffold_188	13969	13975	6	4	no	NA	NA
8865	scaffold_241	2504	2534	30	4	no	NA	NA
8866	scaffold_241	8207	8229	22	8	no	NA	NA
8867	scaffold_241	8337	8368	31	10	no	NA	NA
8868	scaffold_241	8485	8699	214	30	no	NA	NA
8869	scaffold_241	12368	12407	39	12	no	NA	NA
8870	scaffold_241	15535	15562	27	9	no	NA	NA
8871	scaffold_241	16039	16050	11	4	no	NA	NA
8872	scaffold_299	3381	3400	19	6	no	NA	NA
8873	scaffold_299	8887	9600	713	68	no	NA	NA
8874	scaffold_58	438	457	19	6	no	NA	NA
8875	scaffold_58	4150	4168	18	8	no	NA	NA
8876	scaffold_58	7284	7344	60	18	no	NA	NA
8877	scaffold_58	21101	21884	783	72	yes	329819	+
8878	scaffold_58	26956	27384	428	50	yes	396442	-
8879	scaffold_58	71218	71789	571	57	yes	329834	-
8880	scaffold_58	73996	74509	513	54	yes	329835	-
8881	scaffold_58	79718	80769	1051	133	yes	151476,408813	-,-
8882	scaffold_58	81427	83225	1798	188	no	NA	NA
8883	scaffold_58	84097	84836	739	52	yes	329838	+
8884	scaffold_58	98802	99407	605	43	yes	329841	+
8885	scaffold_58	107226	107889	663	77	yes	396457	-
8886	scaffold_58	112378	112666	288	40	yes	396458	-
8887	scaffold_58	131046	131057	11	4	no	NA	NA
8888	scaffold_58	137437	138662	1225	110	yes	329845,329849	-,+
8889	scaffold_58	139084	140244	1160	135	yes	329849	+
8890	scaffold_58	140387	140429	42	8	no	NA	NA
8891	scaffold_58	143098	144090	992	135	yes	329851	-
8892	scaffold_58	146434	147746	1312	92	yes	151569	-
8893	scaffold_58	151212	152215	1003	82	yes	329860	-
8894	scaffold_58	153824	154958	1134	116	yes	329864	-
8895	scaffold_58	188903	190208	1305	91	no	NA	NA
8896	scaffold_58	195909	196854	945	66	no	NA	NA
8897	scaffold_58	212213	213164	951	109	yes	151664	+
8898	scaffold_58	232661	234676	2015	268	yes	151699	-
8899	scaffold_58	235022	236051	1029	120	yes	329899	-
8900	scaffold_58	237282	238939	1657	171	yes	248575	+
8901	scaffold_58	245765	246756	991	111	no	NA	NA
8902	scaffold_58	256211	256978	767	75	no	NA	NA
8903	scaffold_58	276876	276909	33	6	no	NA	NA
8904	scaffold_58	277012	277053	41	12	no	NA	NA
8905	scaffold_58	277221	277317	96	23	no	NA	NA
8906	scaffold_58	304896	305608	712	88	no	NA	NA
8907	scaffold_58	305700	305707	7	4	no	NA	NA
8908	scaffold_58	316257	316771	514	61	no	NA	NA
8909	scaffold_58	317081	317769	688	71	yes	408873	-
8910	scaffold_58	317849	317898	49	10	yes	408873	-
8911	scaffold_58	322113	323523	1410	134	yes	408874	-
8912	scaffold_58	326164	327527	1363	142	yes	329927	-
8913	scaffold_58	349612	349896	284	38	yes	248584	+
8914	scaffold_58	350183	350190	7	4	no	NA	NA
8915	scaffold_58	365556	366173	617	83	yes	329935	-
8916	scaffold_58	372012	373220	1208	161	yes	396487	+
8917	scaffold_58	378198	378837	639	47	yes	329939	-
8918	scaffold_58	386837	387941	1104	140	no	NA	NA
8919	scaffold_58	397959	399338	1379	156	yes	152031	-
8920	scaffold_58	406099	407125	1026	168	yes	152058	+
8921	scaffold_58	414390	415545	1155	124	yes	396497	+
8922	scaffold_58	419724	420686	962	51	yes	396498	-
8923	scaffold_58	425048	426506	1458	201	yes	152165	-
8924	scaffold_58	427722	427729	7	4	no	NA	NA
8925	scaffold_58	430851	432038	1187	163	yes	329965	-
8926	scaffold_58	459887	460699	812	85	yes	329973	-
8927	scaffold_58	462798	462985	187	8	no	NA	NA
8928	scaffold_58	463219	464292	1073	114	yes	408908	+
8929	scaffold_58	472934	474039	1105	105	yes	396504	+
8930	scaffold_58	478312	479189	877	91	yes	248618	-
8931	scaffold_58	479406	480591	1185	130	yes	152299	+
8932	scaffold_58	493960	495504	1544	155	yes	223189	-
8933	scaffold_58	497545	499605	2060	196	yes	408914	-
8934	scaffold_58	500046	500844	798	84	yes	329989	+
8935	scaffold_139	4270	5206	936	80	no	NA	NA
8936	scaffold_139	25550	25896	346	13	yes	336519	+
8937	scaffold_139	49387	50671	1284	124	yes	369449	-
8938	scaffold_139	51766	52318	552	44	yes	336527	+
8939	scaffold_139	52580	52589	9	4	yes	336527	+
8940	scaffold_139	54995	55793	798	79	yes	38047	+
8941	scaffold_170	6173	6192	19	6	no	NA	NA
8942	scaffold_223	5705	5711	6	4	no	NA	NA
8943	scaffold_223	5822	5895	73	18	no	NA	NA
8944	scaffold_223	6153	6334	181	23	no	NA	NA
8945	scaffold_223	6475	6484	9	4	no	NA	NA
8946	scaffold_223	6780	6955	175	23	no	NA	NA
8947	scaffold_223	7096	7105	9	4	no	NA	NA
8948	scaffold_223	7341	7366	25	8	no	NA	NA
8949	scaffold_59	7382	7537	155	22	no	NA	NA
8950	scaffold_59	10856	12272	1416	200	yes	330014	-
8951	scaffold_59	13073	14463	1390	159	yes	330016,330017	-,+
8952	scaffold_59	14864	16081	1217	132	yes	330016,330017	-,+
8953	scaffold_59	19383	20461	1078	125	yes	152425	+
8954	scaffold_59	45820	45957	137	12	yes	413556	+
8955	scaffold_59	55181	56468	1287	211	no	NA	NA
8956	scaffold_59	62326	63613	1287	209	no	NA	NA
8957	scaffold_59	75228	75494	266	21	yes	330032	-
8958	scaffold_59	82317	83715	1398	127	yes	430005	+
8959	scaffold_59	86256	87308	1052	86	yes	330035	+
8960	scaffold_59	91716	92926	1210	125	yes	430007	-
8961	scaffold_59	112076	112527	451	49	yes	430010	+
8962	scaffold_59	115175	115215	40	10	yes	330043	-
8963	scaffold_59	118985	118992	7	4	no	NA	NA
8964	scaffold_59	120237	121147	910	86	yes	330044	-
8965	scaffold_59	123790	123808	18	3	no	NA	NA
8966	scaffold_59	123945	124138	193	18	no	NA	NA
8967	scaffold_59	124650	124975	325	29	yes	330046	-
8968	scaffold_59	130772	130806	34	6	no	NA	NA
8969	scaffold_59	131107	131527	420	37	yes	396533	-
8970	scaffold_59	135952	136860	908	78	yes	330049	+
8971	scaffold_59	146100	147103	1003	103	yes	430018	+
8972	scaffold_59	155487	156642	1155	97	no	NA	NA
8973	scaffold_59	164847	166119	1272	123	yes	413584	-
8974	scaffold_59	168633	169855	1222	122	yes	330066	-
8975	scaffold_59	189445	189836	391	14	no	NA	NA
8976	scaffold_59	190358	190430	72	3	yes	300201	+
8977	scaffold_59	200254	201630	1376	164	yes	248651	-
8978	scaffold_59	204207	205118	911	84	yes	330074	+
8979	scaffold_59	215426	216431	1005	125	no	NA	NA
8980	scaffold_59	223396	225182	1786	178	yes	152658	+
8981	scaffold_59	232691	233414	723	58	yes	152695	+
8982	scaffold_59	241180	242896	1716	139	yes	413597	-
8983	scaffold_59	245502	246670	1168	129	yes	330092	-
8984	scaffold_59	247025	248101	1076	112	yes	330092,430033	-,+
8985	scaffold_59	248558	248689	131	4	no	NA	NA
8986	scaffold_59	250666	251818	1152	134	yes	330095	+
8987	scaffold_59	257968	258745	777	112	yes	330097	-
8988	scaffold_59	262177	263490	1313	149	yes	430035	-
8989	scaffold_59	267681	269036	1355	103	no	NA	NA
8990	scaffold_59	269164	269177	13	4	no	NA	NA
8991	scaffold_59	275893	275940	47	12	no	NA	NA
8992	scaffold_59	289043	289096	53	4	no	NA	NA
8993	scaffold_59	289223	290507	1284	140	yes	430041	-
8994	scaffold_59	290968	291525	557	31	no	NA	NA
8995	scaffold_59	294726	296029	1303	212	yes	330114	+
8996	scaffold_59	301099	301150	51	4	no	NA	NA
8997	scaffold_59	301268	302179	911	127	no	NA	NA
8998	scaffold_59	306328	307239	911	128	no	NA	NA
8999	scaffold_59	318166	318985	819	80	yes	152846	-
9000	scaffold_59	321030	322181	1151	147	yes	396563	+
9001	scaffold_59	334695	335748	1053	109	yes	430050	+
9002	scaffold_59	340272	341362	1090	126	yes	330127	-
9003	scaffold_59	341625	341632	7	4	yes	330127	-
9004	scaffold_59	352570	353174	604	81	yes	396570	-
9005	scaffold_59	358349	358630	281	39	yes	396571	-
9006	scaffold_59	372887	374559	1672	241	yes	396573	+
9007	scaffold_59	376053	376060	7	4	no	NA	NA
9008	scaffold_59	376292	377908	1616	235	no	NA	NA
9009	scaffold_59	382209	382903	694	78	yes	330143	+
9010	scaffold_59	403591	404271	680	59	yes	236326	-
9011	scaffold_59	406907	408448	1541	200	yes	300247	+
9012	scaffold_59	423978	425115	1137	154	yes	330153	-
9013	scaffold_59	448380	449509	1129	163	yes	430067	+
9014	scaffold_59	463654	465030	1376	143	yes	153160	+
9015	scaffold_59	469702	471184	1482	153	yes	330178	+
9016	scaffold_99	9000	10222	1222	111	no	NA	NA
9017	scaffold_99	13221	14608	1387	130	no	NA	NA
9018	scaffold_99	19392	19924	532	36	yes	196083	+
9019	scaffold_99	20059	20247	188	25	no	NA	NA
9020	scaffold_99	22800	22817	17	8	yes	419350	+
9021	scaffold_99	25268	26288	1020	110	yes	196112	+
9022	scaffold_99	38109	38480	371	43	no	NA	NA
9023	scaffold_99	39870	40790	920	118	no	NA	NA
9024	scaffold_99	40916	40945	29	12	no	NA	NA
9025	scaffold_99	47752	48654	902	104	yes	196160	+
9026	scaffold_99	54844	56106	1262	120	yes	196229	+
9027	scaffold_99	62142	62197	55	9	yes	196244	+
9028	scaffold_99	62723	63375	652	76	yes	196244	+
9029	scaffold_99	63470	63522	52	16	no	NA	NA
9030	scaffold_99	68480	68707	227	36	no	NA	NA
9031	scaffold_99	68799	68891	92	20	no	NA	NA
9032	scaffold_99	68996	69228	232	30	no	NA	NA
9033	scaffold_99	72307	72536	229	14	yes	334501	+
9034	scaffold_99	85103	85111	8	4	no	NA	NA
9035	scaffold_99	85211	85970	759	92	no	NA	NA
9036	scaffold_99	91013	91252	239	14	yes	431880	+
9037	scaffold_99	91345	91838	493	50	yes	431880	+
9038	scaffold_99	91946	92005	59	7	no	NA	NA
9039	scaffold_99	100241	101537	1296	136	yes	431881	+
9040	scaffold_99	132190	132210	20	6	no	NA	NA
9041	scaffold_99	134559	134583	24	6	no	NA	NA
9042	scaffold_99	134721	135626	905	57	no	NA	NA
9043	scaffold_99	136030	136043	13	10	no	NA	NA
9044	scaffold_99	136300	137552	1252	103	no	NA	NA
9045	scaffold_99	200101	200755	654	48	no	NA	NA
9046	scaffold_99	201097	201399	302	42	no	NA	NA
9047	scaffold_99	201581	202032	451	48	no	NA	NA
9048	scaffold_137	2248	2904	656	34	yes	417624	+
9049	scaffold_137	6091	7441	1350	135	yes	417625	+
9050	scaffold_137	13339	14278	939	88	yes	336482	+
9051	scaffold_137	26978	28228	1250	116	yes	336487	+
9052	scaffold_137	32913	34034	1121	86	yes	417632	-
9053	scaffold_137	38349	39690	1341	139	yes	336491	+
9054	scaffold_137	42265	42791	526	49	yes	399043	+
9055	scaffold_137	49228	49442	214	32	no	NA	NA
9056	scaffold_137	49542	49590	48	14	no	NA	NA
9057	scaffold_137	49698	49720	22	8	no	NA	NA
9058	scaffold_137	56148	56246	98	17	yes	417637	+
9059	scaffold_137	61119	61382	263	30	yes	37819	-
9060	scaffold_166	14941	15155	214	32	no	NA	NA
9061	scaffold_166	15255	15303	48	14	no	NA	NA
9062	scaffold_166	15411	15433	22	8	no	NA	NA
9063	scaffold_166	29791	29810	19	6	no	NA	NA
9064	scaffold_217	2511	2569	58	9	no	NA	NA
9065	scaffold_217	2696	2717	21	5	no	NA	NA
9066	scaffold_217	2810	2898	88	8	no	NA	NA
9067	scaffold_217	3014	3310	296	34	no	NA	NA
9068	scaffold_217	3418	4289	871	64	yes	432809	-
9069	scaffold_217	4770	4993	223	13	no	NA	NA
9070	scaffold_217	5178	5445	267	28	no	NA	NA
9071	scaffold_272	4622	4638	16	4	no	NA	NA
9072	scaffold_60	58241	58301	60	22	no	NA	NA
9073	scaffold_60	61057	62462	1405	179	no	NA	NA
9074	scaffold_60	66095	66723	628	73	yes	236348,396601	-,-
9075	scaffold_60	70246	71480	1234	131	yes	330190	+
9076	scaffold_60	74480	76505	2025	171	yes	330196,330198	-,+
9077	scaffold_60	76686	78487	1801	171	yes	330198	+
9078	scaffold_60	79145	79163	18	4	no	NA	NA
9079	scaffold_60	85170	86212	1042	126	yes	300282	+
9080	scaffold_60	86552	87395	843	104	no	NA	NA
9081	scaffold_60	87683	87707	24	6	no	NA	NA
9082	scaffold_60	97278	97308	30	8	no	NA	NA
9083	scaffold_60	97461	98536	1075	100	yes	430081	-
9084	scaffold_60	107231	108363	1132	124	yes	330214	-
9085	scaffold_60	138960	139933	973	88	yes	157680	+
9086	scaffold_60	144645	144667	22	6	no	NA	NA
9087	scaffold_60	166741	166819	78	12	yes	330225	+
9088	scaffold_60	207562	207586	24	4	no	NA	NA
9089	scaffold_60	228336	228563	227	14	yes	330237	+
9090	scaffold_60	258968	259037	69	14	yes	379918	-
9091	scaffold_60	259189	259367	178	22	yes	379918	-
9092	scaffold_60	289022	291402	2380	226	yes	330244	+
9093	scaffold_60	291603	292398	795	79	yes	379925	+
9094	scaffold_60	297312	298499	1187	129	yes	409977	+
9095	scaffold_60	321090	321174	84	6	no	NA	NA
9096	scaffold_60	321302	322099	797	109	yes	330256,379929	+,-
9097	scaffold_60	322292	323380	1088	110	yes	330256,379929,157856	+,-,+
9098	scaffold_60	444880	444908	28	8	no	NA	NA
9099	scaffold_60	445889	446523	634	70	no	NA	NA
9100	scaffold_60	446898	447079	181	20	no	NA	NA
9101	scaffold_60	448740	449093	353	28	no	NA	NA
9102	scaffold_60	449670	449723	53	8	yes	379972	+
9103	scaffold_60	460908	460984	76	12	yes	410021	+
9104	scaffold_60	461080	461161	81	18	no	NA	NA
9105	scaffold_60	461315	461328	13	4	no	NA	NA
9106	scaffold_60	473468	474211	743	94	no	NA	NA
9107	scaffold_60	474356	474449	93	18	no	NA	NA
9108	scaffold_98	2850	3494	644	72	no	NA	NA
9109	scaffold_98	9734	11516	1782	204	yes	334360	+
9110	scaffold_98	15467	15913	446	50	yes	334361	+
9111	scaffold_98	16052	16114	62	8	yes	334361	+
9112	scaffold_98	16213	16222	9	4	no	NA	NA
9113	scaffold_98	20329	21153	824	74	no	NA	NA
9114	scaffold_98	27901	28824	923	112	yes	334367	-
9115	scaffold_98	42058	43002	944	94	yes	398315	-
9116	scaffold_98	43423	43442	19	6	yes	398315	-
9117	scaffold_98	45048	46003	955	84	yes	334374	-
9118	scaffold_98	53110	53406	296	43	yes	195656	+
9119	scaffold_98	54534	54556	22	8	no	NA	NA
9120	scaffold_98	55649	55843	194	15	yes	334380	+
9121	scaffold_98	57486	58338	852	107	no	NA	NA
9122	scaffold_98	63052	63898	846	84	yes	409865	-
9123	scaffold_98	68974	70542	1568	155	yes	334384,409867	+,-
9124	scaffold_98	70770	71837	1067	147	yes	334384	+
9125	scaffold_98	101689	102140	451	29	yes	334390	+
9126	scaffold_98	125909	127102	1193	120	no	NA	NA
9127	scaffold_98	135689	138347	2658	219	yes	250301,334401	+,-
9128	scaffold_98	138634	139618	984	136	yes	334401,237970	-,+
9129	scaffold_98	140708	141827	1119	138	yes	334406	+
9130	scaffold_98	150665	152219	1554	104	yes	334411	-
9131	scaffold_98	154529	155513	984	103	yes	409891	+
9132	scaffold_98	161501	162643	1142	108	yes	334421,431864	-,+
9133	scaffold_98	166418	167872	1454	149	yes	302517,334424	+,+
9134	scaffold_98	181257	181277	20	6	no	NA	NA
9135	scaffold_98	206823	206858	35	12	no	NA	NA
9136	scaffold_98	210959	211665	706	79	no	NA	NA
9137	scaffold_98	211831	212386	555	43	no	NA	NA
9138	scaffold_98	216366	216840	474	16	yes	196023	-
9139	scaffold_134	1678	1720	42	13	no	NA	NA
9140	scaffold_134	5349	5368	19	6	no	NA	NA
9141	scaffold_134	8250	9165	915	105	yes	336386	-
9142	scaffold_134	10389	11101	712	83	yes	37423	+
9143	scaffold_134	75093	75113	20	7	no	NA	NA
9144	scaffold_203	9399	9467	68	20	no	NA	NA
9145	scaffold_203	12099	12176	77	22	no	NA	NA
9146	scaffold_203	13753	13833	80	20	no	NA	NA
9147	scaffold_203	18542	18610	68	16	no	NA	NA
9148	scaffold_265	6842	7337	495	70	no	NA	NA
9149	scaffold_265	8018	8075	57	16	no	NA	NA
9150	scaffold_61	13023	14212	1189	107	yes	366332	-
9151	scaffold_61	15041	15081	40	8	yes	330291	+
9152	scaffold_61	15246	15577	331	35	yes	330291	+
9153	scaffold_61	19078	20072	994	88	yes	330293	-
9154	scaffold_61	24052	24978	926	105	yes	236371	-
9155	scaffold_61	28680	29749	1069	94	no	NA	NA
9156	scaffold_61	38853	39820	967	175	yes	223371	+
9157	scaffold_61	48436	49902	1466	104	yes	386054	+
9158	scaffold_61	62529	64174	1645	136	yes	330313	-
9159	scaffold_61	67948	69290	1342	123	yes	396663	+
9160	scaffold_61	80353	81522	1169	168	no	NA	NA
9161	scaffold_61	83870	84951	1081	105	yes	330319	-
9162	scaffold_61	94313	95285	972	59	no	NA	NA
9163	scaffold_61	113291	114868	1577	218	yes	236392	-
9164	scaffold_61	121798	122727	929	95	yes	330330	+
9165	scaffold_61	122827	122868	41	6	no	NA	NA
9166	scaffold_61	127818	127829	11	3	yes	330335	+
9167	scaffold_61	131436	131992	556	45	yes	430155	-
9168	scaffold_61	133361	134437	1076	137	yes	330338	+
9169	scaffold_61	143062	144301	1239	126	yes	330342	+
9170	scaffold_61	145968	147343	1375	173	yes	330343	-
9171	scaffold_61	150145	151286	1141	76	yes	330345	+
9172	scaffold_61	156545	157822	1277	173	yes	430160	-
9173	scaffold_61	161927	161936	9	6	no	NA	NA
9174	scaffold_61	166545	167668	1123	127	yes	248784	-
9175	scaffold_61	169107	169900	793	82	no	NA	NA
9176	scaffold_61	170927	171581	654	61	yes	410733	+
9177	scaffold_61	176216	176242	26	6	no	NA	NA
9178	scaffold_61	176405	177182	777	65	yes	430163	-
9179	scaffold_61	179563	180352	789	115	yes	330355	+
9180	scaffold_61	182517	184058	1541	111	no	NA	NA
9181	scaffold_61	196487	197817	1330	155	yes	330366	+
9182	scaffold_61	209590	210853	1263	187	no	NA	NA
9183	scaffold_61	221500	221508	8	4	no	NA	NA
9184	scaffold_61	221834	222963	1129	77	no	NA	NA
9185	scaffold_61	223728	225362	1634	193	yes	158742	-
9186	scaffold_61	235454	236676	1222	86	yes	300404	+
9187	scaffold_61	246810	246981	171	16	no	NA	NA
9188	scaffold_61	247251	248330	1079	142	yes	430171	-
9189	scaffold_61	249496	251094	1598	175	yes	330383	+
9190	scaffold_61	255774	255812	38	14	yes	330385	+
9191	scaffold_61	255871	256862	991	146	yes	330385	+
9192	scaffold_61	260558	261894	1336	182	yes	330390	-
9193	scaffold_61	265166	266567	1401	148	yes	158870	-
9194	scaffold_61	275603	276762	1159	184	yes	330404	-
9195	scaffold_61	287353	288510	1157	84	yes	330419	-
9196	scaffold_61	297343	298573	1230	121	yes	330431	-
9197	scaffold_61	300818	302096	1278	171	yes	330433	-
9198	scaffold_61	308550	309482	932	84	yes	300422	-
9199	scaffold_61	320628	321480	852	71	yes	330438	-
9200	scaffold_61	329368	329380	12	4	no	NA	NA
9201	scaffold_61	329767	330404	637	77	no	NA	NA
9202	scaffold_61	331874	333307	1433	154	no	NA	NA
9203	scaffold_61	338181	339893	1712	175	yes	248813	-
9204	scaffold_61	343818	345146	1328	149	yes	430188	+
9205	scaffold_61	352169	353398	1229	186	yes	248815	-
9206	scaffold_61	354899	355849	950	96	yes	330457	-
9207	scaffold_61	360263	361634	1371	198	yes	410770	-
9208	scaffold_61	363446	365148	1702	166	yes	300433	+
9209	scaffold_61	370579	372031	1452	158	yes	223451	-
9210	scaffold_61	374474	375335	861	68	yes	396720	-
9211	scaffold_61	382632	383885	1253	146	yes	396721	-
9212	scaffold_61	385301	386429	1128	112	yes	223444	+
9213	scaffold_61	389597	390755	1158	116	yes	330472	+
9214	scaffold_61	398031	399512	1481	155	yes	430199	+
9215	scaffold_61	405715	407200	1485	189	yes	300440	-
9216	scaffold_61	421360	422346	986	88	no	NA	NA
9217	scaffold_61	427660	428434	774	80	yes	300446	-
9218	scaffold_61	432343	433133	790	83	yes	223342	-
9219	scaffold_61	433742	434977	1235	94	no	NA	NA
9220	scaffold_61	438206	439782	1576	168	yes	410788	+
9221	scaffold_61	439935	439987	52	10	no	NA	NA
9222	scaffold_61	442357	443471	1114	112	yes	330500	+
9223	scaffold_61	460108	460642	534	72	no	NA	NA
9224	scaffold_97	17207	17226	19	7	no	NA	NA
9225	scaffold_97	35778	37114	1336	184	no	NA	NA
9226	scaffold_97	37197	37204	7	4	no	NA	NA
9227	scaffold_97	53800	53833	33	6	no	NA	NA
9228	scaffold_97	55867	56927	1060	103	yes	398291	-
9229	scaffold_97	64907	64912	5	4	no	NA	NA
9230	scaffold_97	92873	93772	899	98	no	NA	NA
9231	scaffold_97	126071	126281	210	30	no	NA	NA
9232	scaffold_97	126385	126483	98	18	no	NA	NA
9233	scaffold_97	126553	126593	40	13	no	NA	NA
9234	scaffold_97	215630	215710	80	6	no	NA	NA
9235	scaffold_97	215777	216743	966	112	no	NA	NA
9236	scaffold_97	218613	219098	485	45	yes	383236	-
9237	scaffold_97	220808	221382	574	48	yes	334337	-
9238	scaffold_97	225656	225852	196	11	no	NA	NA
9239	scaffold_97	226025	227113	1088	84	yes	302477	-
9240	scaffold_132	3157	3226	69	17	no	NA	NA
9241	scaffold_132	3902	4791	889	97	yes	336356,336358	-,+
9242	scaffold_132	5049	5631	582	70	yes	336356,336358	-,+
9243	scaffold_132	20109	20936	827	80	yes	37316	+
9244	scaffold_132	24147	25505	1358	151	yes	37324	+
9245	scaffold_132	31387	31811	424	48	yes	37333	+
9246	scaffold_132	31964	32002	38	10	no	NA	NA
9247	scaffold_132	38609	39867	1258	147	yes	432561	+
9248	scaffold_132	50855	50866	11	4	yes	399002	-
9249	scaffold_159	40227	40266	39	5	no	NA	NA
9250	scaffold_212	9631	10882	1251	192	no	NA	NA
9251	scaffold_212	13358	13441	83	25	no	NA	NA
9252	scaffold_269	4110	4149	39	12	no	NA	NA
9253	scaffold_269	7411	7430	19	6	no	NA	NA
9254	scaffold_269	7904	7931	27	9	no	NA	NA
9255	scaffold_269	11065	11103	38	11	no	NA	NA
9256	scaffold_310	3058	3797	739	31	yes	386321	-
9257	scaffold_310	4692	5813	1121	107	yes	303926	+
9258	scaffold_310	8439	8801	362	14	yes	337702	+
9259	scaffold_62	48075	50216	2141	269	yes	210842,430216	+,-
9260	scaffold_62	51638	52548	910	93	yes	330514	+
9261	scaffold_62	52642	52651	9	4	no	NA	NA
9262	scaffold_62	52763	52835	72	12	no	NA	NA
9263	scaffold_62	67368	67909	541	57	yes	330515	+
9264	scaffold_62	69902	69919	17	6	yes	330516	+
9265	scaffold_62	75235	76555	1320	171	no	NA	NA
9266	scaffold_62	92715	92900	185	12	yes	330520	-
9267	scaffold_62	109250	109519	269	28	yes	248866	-
9268	scaffold_62	176987	178305	1318	150	yes	300487	+
9269	scaffold_62	186852	187986	1134	122	no	NA	NA
9270	scaffold_62	206120	206350	230	24	no	NA	NA
9271	scaffold_62	209889	209900	11	4	no	NA	NA
9272	scaffold_62	210062	210386	324	35	yes	330544	-
9273	scaffold_62	220669	220995	326	42	yes	396763	+
9274	scaffold_62	229712	230655	943	116	yes	159803	-
9275	scaffold_62	244167	244987	820	100	no	NA	NA
9276	scaffold_62	266034	267103	1069	129	yes	330557	-
9277	scaffold_62	272803	273423	620	69	yes	330561	+
9278	scaffold_62	277318	279339	2021	226	no	NA	NA
9279	scaffold_62	281389	283542	2153	238	no	NA	NA
9280	scaffold_62	285143	286392	1249	130	yes	330564	-
9281	scaffold_62	291845	295509	3664	395	no	NA	NA
9282	scaffold_62	298368	300125	1757	192	no	NA	NA
9283	scaffold_62	302093	303739	1646	210	no	NA	NA
9284	scaffold_62	317444	318581	1137	161	yes	248895	-
9285	scaffold_62	323261	323924	663	54	yes	430259	-
9286	scaffold_62	326694	327156	462	26	yes	330570	-
9287	scaffold_62	327271	327646	375	30	yes	330570	-
9288	scaffold_62	335720	336865	1145	174	yes	396779	-
9289	scaffold_62	362928	364575	1647	161	yes	417995	-
9290	scaffold_62	371474	371939	465	63	no	NA	NA
9291	scaffold_62	372688	372703	15	6	yes	330580	-
9292	scaffold_62	374514	374520	6	4	no	NA	NA
9293	scaffold_62	399067	400166	1099	146	yes	430270	-
9294	scaffold_62	406520	407472	952	88	yes	430271	-
9295	scaffold_62	414125	414596	471	40	yes	160094	-
9296	scaffold_62	434896	435711	815	64	yes	430274	-
9297	scaffold_62	444986	445639	653	53	yes	430275	-
9298	scaffold_62	453370	454026	656	54	yes	430276	-
9299	scaffold_96	28918	28966	48	12	no	NA	NA
9300	scaffold_96	32725	32792	67	16	no	NA	NA
9301	scaffold_96	34114	34181	67	18	no	NA	NA
9302	scaffold_96	35364	35431	67	18	no	NA	NA
9303	scaffold_96	36559	36626	67	18	no	NA	NA
9304	scaffold_96	37816	37875	59	15	no	NA	NA
9305	scaffold_96	39452	39519	67	18	no	NA	NA
9306	scaffold_96	40659	40718	59	16	no	NA	NA
9307	scaffold_96	41866	41925	59	16	no	NA	NA
9308	scaffold_96	43172	43239	67	18	no	NA	NA
9309	scaffold_96	44457	44524	67	18	no	NA	NA
9310	scaffold_96	45763	45830	67	18	no	NA	NA
9311	scaffold_96	47103	47162	59	14	no	NA	NA
9312	scaffold_96	58714	58781	67	16	yes	415493	+
9313	scaffold_96	61297	61356	59	12	no	NA	NA
9314	scaffold_96	62356	62423	67	14	no	NA	NA
9315	scaffold_96	63421	63488	67	15	no	NA	NA
9316	scaffold_96	64479	64546	67	16	no	NA	NA
9317	scaffold_96	65537	65603	66	15	no	NA	NA
9318	scaffold_96	66579	66646	67	14	no	NA	NA
9319	scaffold_96	84410	84446	36	12	yes	415502	+
9320	scaffold_96	90675	91511	836	76	no	NA	NA
9321	scaffold_96	98286	99489	1203	128	yes	415506	-
9322	scaffold_96	100515	101194	679	70	yes	431799	+
9323	scaffold_96	146968	148040	1072	161	yes	431803	-
9324	scaffold_96	220596	221855	1259	121	no	NA	NA
9325	scaffold_136	6135	6149	14	6	no	NA	NA
9326	scaffold_136	6627	6651	24	8	no	NA	NA
9327	scaffold_136	17967	18773	806	98	yes	369394	+
9328	scaffold_136	30086	30107	21	6	yes	419416	-
9329	scaffold_136	31017	31094	77	22	no	NA	NA
9330	scaffold_136	31928	31996	68	18	no	NA	NA
9331	scaffold_136	32980	33057	77	18	no	NA	NA
9332	scaffold_136	33983	34051	68	16	no	NA	NA
9333	scaffold_136	38612	38692	80	20	no	NA	NA
9334	scaffold_136	44784	44851	67	16	no	NA	NA
9335	scaffold_136	45924	45991	67	16	no	NA	NA
9336	scaffold_136	47014	47081	67	19	no	NA	NA
9337	scaffold_136	48784	48843	59	13	no	NA	NA
9338	scaffold_136	61958	61979	21	6	no	NA	NA
9339	scaffold_156	18654	18685	31	9	no	NA	NA
9340	scaffold_156	18793	18833	40	12	no	NA	NA
9341	scaffold_156	18941	19155	214	30	no	NA	NA
9342	scaffold_156	29934	31076	1142	96	no	NA	NA
9343	scaffold_156	38170	38189	19	6	no	NA	NA
9344	scaffold_156	41408	41426	18	5	no	NA	NA
9345	scaffold_254	6784	7723	939	126	yes	337444	-
9346	scaffold_311	7988	8521	533	65	no	NA	NA
9347	scaffold_63	5327	5384	57	3	no	NA	NA
9348	scaffold_63	5497	5627	130	14	no	NA	NA
9349	scaffold_63	5741	6745	1004	73	no	NA	NA
9350	scaffold_63	9971	10038	67	15	no	NA	NA
9351	scaffold_63	10949	11025	76	17	no	NA	NA
9352	scaffold_63	11833	11901	68	20	no	NA	NA
9353	scaffold_63	15102	15200	98	18	yes	300537	-
9354	scaffold_63	22680	22758	78	16	yes	300539	-
9355	scaffold_63	25689	25756	67	14	no	NA	NA
9356	scaffold_63	26587	26654	67	16	no	NA	NA
9357	scaffold_63	27813	27880	67	16	yes	405391	-
9358	scaffold_63	29044	29112	68	16	no	NA	NA
9359	scaffold_63	30334	30409	75	19	yes	405392	-
9360	scaffold_63	31218	31286	68	18	no	NA	NA
9361	scaffold_63	32295	32362	67	18	no	NA	NA
9362	scaffold_63	33211	33270	59	13	no	NA	NA
9363	scaffold_63	44914	44925	11	4	no	NA	NA
9364	scaffold_63	45208	45242	34	10	no	NA	NA
9365	scaffold_63	45459	45683	224	16	yes	396796	-
9366	scaffold_63	48940	48983	43	8	yes	330612	+
9367	scaffold_63	49299	49326	27	8	yes	330612	+
9368	scaffold_63	53699	54012	313	40	yes	330613	-
9369	scaffold_63	70259	71589	1330	165	yes	430283,430284	+,+
9370	scaffold_63	94495	99092	4597	447	yes	160224,330624	+,-
9371	scaffold_63	99574	100606	1032	104	yes	160224,330624	+,-
9372	scaffold_63	124494	124551	57	14	no	NA	NA
9373	scaffold_63	146508	147403	895	81	no	NA	NA
9374	scaffold_63	148501	148549	48	16	no	NA	NA
9375	scaffold_63	179018	179029	11	4	no	NA	NA
9376	scaffold_63	179213	179448	235	24	no	NA	NA
9377	scaffold_63	179592	179608	16	4	no	NA	NA
9378	scaffold_63	179714	181140	1426	123	no	NA	NA
9379	scaffold_63	181276	181753	477	56	no	NA	NA
9380	scaffold_63	189193	190222	1029	138	no	NA	NA
9381	scaffold_63	209086	209119	33	14	no	NA	NA
9382	scaffold_63	216439	216713	274	37	no	NA	NA
9383	scaffold_63	216860	216877	17	6	no	NA	NA
9384	scaffold_63	217525	217555	30	6	yes	405426	-
9385	scaffold_63	217671	218513	842	85	yes	405426	-
9386	scaffold_63	219568	219658	90	15	no	NA	NA
9387	scaffold_63	223648	223669	21	10	no	NA	NA
9388	scaffold_63	227017	227023	6	4	no	NA	NA
9389	scaffold_63	227252	227265	13	4	no	NA	NA
9390	scaffold_63	228157	228164	7	4	yes	380163	+
9391	scaffold_63	250639	251746	1107	150	no	NA	NA
9392	scaffold_63	252458	252494	36	12	no	NA	NA
9393	scaffold_63	263326	263933	607	67	no	NA	NA
9394	scaffold_63	265120	265165	45	12	no	NA	NA
9395	scaffold_63	265362	265408	46	10	no	NA	NA
9396	scaffold_63	266137	266526	389	24	yes	430300	+
9397	scaffold_63	286804	286832	28	8	no	NA	NA
9398	scaffold_63	287893	288281	388	32	yes	396816	+
9399	scaffold_63	296598	296699	101	23	no	NA	NA
9400	scaffold_63	296993	297009	16	6	no	NA	NA
9401	scaffold_63	297599	297779	180	34	no	NA	NA
9402	scaffold_63	301328	301959	631	89	no	NA	NA
9403	scaffold_63	304221	305095	874	107	no	NA	NA
9404	scaffold_63	308119	308148	29	10	yes	380180	+
9405	scaffold_63	330783	330791	8	4	no	NA	NA
9406	scaffold_63	331248	331279	31	8	no	NA	NA
9407	scaffold_63	333094	333849	755	95	no	NA	NA
9408	scaffold_63	334021	334464	443	34	yes	405439	+
9409	scaffold_63	337059	337070	11	6	no	NA	NA
9410	scaffold_63	340772	340831	59	21	no	NA	NA
9411	scaffold_63	362218	362686	468	68	yes	380184	-
9412	scaffold_63	364052	364062	10	4	no	NA	NA
9413	scaffold_63	364389	364497	108	32	no	NA	NA
9414	scaffold_63	364625	364761	136	14	no	NA	NA
9415	scaffold_63	364850	365194	344	28	no	NA	NA
9416	scaffold_63	378032	378864	832	98	yes	405446	+
9417	scaffold_63	423003	423055	52	16	no	NA	NA
9418	scaffold_63	423295	423454	159	10	no	NA	NA
9419	scaffold_63	423784	424979	1195	94	no	NA	NA
9420	scaffold_63	426175	426206	31	10	no	NA	NA
9421	scaffold_63	426333	426403	70	16	no	NA	NA
9422	scaffold_63	432880	433897	1017	149	no	NA	NA
9423	scaffold_63	437219	437248	29	6	no	NA	NA
9424	scaffold_63	437388	438621	1233	133	no	NA	NA
9425	scaffold_63	442762	443267	505	63	yes	380194	+
9426	scaffold_95	42024	43119	1095	95	yes	431759	+
9427	scaffold_95	58692	58714	22	4	yes	406764	-
9428	scaffold_95	58838	59081	243	29	yes	406764	-
9429	scaffold_95	65921	67044	1123	155	yes	406766	-
9430	scaffold_95	68021	68940	919	103	no	NA	NA
9431	scaffold_95	75021	75700	679	57	yes	431762	-
9432	scaffold_95	88491	89446	955	108	yes	334213	+
9433	scaffold_95	93442	93941	499	73	yes	334214	+
9434	scaffold_95	101958	102714	756	56	yes	302375	-
9435	scaffold_95	128286	129410	1124	140	yes	194380	-
9436	scaffold_95	132440	133473	1033	114	no	NA	NA
9437	scaffold_95	135068	136588	1520	179	yes	194444	-
9438	scaffold_95	137679	137789	110	8	yes	334225	-
9439	scaffold_95	137891	138183	292	33	yes	334225	-
9440	scaffold_95	138644	139637	993	83	yes	334225,334226,334228	-,-,+
9441	scaffold_95	140179	141347	1168	131	yes	334228	+
9442	scaffold_95	143940	144911	971	126	yes	334231,431774	+,-
9443	scaffold_95	145058	146142	1084	126	yes	334231,431774	+,-
9444	scaffold_95	153336	154650	1314	146	yes	431776	-
9445	scaffold_95	157631	158776	1145	106	yes	406786	-
9446	scaffold_95	159841	160625	784	122	yes	334244	-
9447	scaffold_95	160839	160857	18	4	yes	334244	-
9448	scaffold_95	161213	162608	1395	182	yes	406788	+
9449	scaffold_95	171544	172911	1367	151	yes	431780	-
9450	scaffold_95	175135	176265	1130	151	yes	398262	-
9451	scaffold_95	180088	180971	883	56	yes	431782	+
9452	scaffold_95	181211	181239	28	12	no	NA	NA
9453	scaffold_95	189972	191355	1383	185	yes	334260	-
9454	scaffold_95	194613	195725	1112	103	yes	194686	-
9455	scaffold_95	203339	204119	780	87	yes	334268	+
9456	scaffold_95	213518	214880	1362	185	yes	334273	+
9457	scaffold_95	223788	224155	367	22	yes	398272	-
9458	scaffold_131	5829	6392	563	48	no	NA	NA
9459	scaffold_131	17018	18402	1384	170	yes	336340	+
9460	scaffold_131	18602	19394	792	79	yes	336340	+
9461	scaffold_131	61446	61453	7	4	yes	408258	+
9462	scaffold_131	65923	67074	1151	152	no	NA	NA
9463	scaffold_131	71065	71804	739	86	no	NA	NA
9464	scaffold_157	37012	37393	381	27	yes	336753	+
9465	scaffold_369	1851	2350	499	32	no	NA	NA
9466	scaffold_13	29753	30889	1136	110	yes	423791	-
9467	scaffold_13	35586	36700	1114	129	no	NA	NA
9468	scaffold_13	43114	43671	557	63	yes	33057	+
9469	scaffold_13	47857	48275	418	39	yes	390442	-
9470	scaffold_13	50865	52090	1225	118	yes	33085	-
9471	scaffold_13	66852	68043	1191	106	yes	413664	-
9472	scaffold_13	73788	75213	1425	181	yes	314559	+
9473	scaffold_13	95450	95948	498	33	no	NA	NA
9474	scaffold_13	125981	126952	971	54	yes	413678	+
9475	scaffold_13	131994	133003	1009	92	yes	314588	-
9476	scaffold_13	138420	139681	1261	114	yes	33271	+
9477	scaffold_13	151711	151732	21	6	yes	242986	-
9478	scaffold_13	152001	152044	43	4	yes	242986	-
9479	scaffold_13	156013	157951	1938	178	yes	292684	+
9480	scaffold_13	163704	164682	978	94	yes	314597,314598	-,+
9481	scaffold_13	164919	166175	1256	147	yes	314598	+
9482	scaffold_13	167258	168262	1004	124	yes	292687	-
9483	scaffold_13	169423	170570	1147	115	yes	413687	+
9484	scaffold_13	177934	178375	441	32	yes	314609	+
9485	scaffold_13	182996	183748	752	73	yes	413691	+
9486	scaffold_13	187514	188455	941	70	yes	314614	-
9487	scaffold_13	190980	191669	689	88	yes	314619	+
9488	scaffold_13	194305	195019	714	88	yes	314622	+
9489	scaffold_13	204383	204409	26	8	no	NA	NA
9490	scaffold_13	204710	205472	762	78	yes	314627,314630	-,+
9491	scaffold_13	205716	206630	914	105	yes	314627,314630	-,+
9492	scaffold_13	207803	209355	1552	213	yes	314634	-
9493	scaffold_13	219700	220724	1024	124	yes	369079	-
9494	scaffold_13	224299	225830	1531	160	yes	33601	-
9495	scaffold_13	226157	227834	1677	142	no	NA	NA
9496	scaffold_13	228143	229554	1411	154	yes	314649	-
9497	scaffold_13	234177	235574	1397	131	yes	413707	+
9498	scaffold_13	250883	251542	659	74	yes	423831	+
9499	scaffold_13	254525	255898	1373	119	yes	413711	+
9500	scaffold_13	258259	259192	933	113	no	NA	NA
9501	scaffold_13	264794	266427	1633	207	yes	33671	-
9502	scaffold_13	270449	270682	233	42	no	NA	NA
9503	scaffold_13	271073	271778	705	42	yes	423835	-
9504	scaffold_13	280454	281858	1404	117	yes	423837	-
9505	scaffold_13	285377	286906	1529	145	yes	33720	-
9506	scaffold_13	301889	301916	27	8	yes	423840	+
9507	scaffold_13	306192	307173	981	114	yes	292718	-
9508	scaffold_13	312280	313182	902	87	yes	314677	+
9509	scaffold_13	337174	337735	561	50	yes	423845	-
9510	scaffold_13	347391	348336	945	61	yes	292726	+
9511	scaffold_13	364538	365667	1129	141	yes	314699	+
9512	scaffold_13	372305	373339	1034	60	yes	413736	+
9513	scaffold_13	377167	378397	1230	140	no	NA	NA
9514	scaffold_13	394731	395024	293	27	no	NA	NA
9515	scaffold_13	410606	411878	1272	126	yes	314707	+
9516	scaffold_13	413465	414848	1383	171	yes	314711	+
9517	scaffold_13	421337	422585	1248	126	yes	34037,423858	+,-
9518	scaffold_13	422935	424021	1086	124	yes	34037,423858	+,-
9519	scaffold_13	431882	433217	1335	196	yes	314720	+
9520	scaffold_13	440252	441742	1490	123	yes	413750	-
9521	scaffold_13	451143	452301	1158	115	yes	292742	-
9522	scaffold_13	457249	458557	1308	149	yes	243019	-
9523	scaffold_13	464678	465703	1025	121	yes	216820	+
9524	scaffold_13	469522	469608	86	8	no	NA	NA
9525	scaffold_13	469761	470640	879	105	yes	314732,423866	+,-
9526	scaffold_13	470879	472042	1163	134	yes	314732,423866	+,-
9527	scaffold_13	474192	475218	1026	115	yes	390517	-
9528	scaffold_13	476888	476897	9	4	no	NA	NA
9529	scaffold_13	477051	477992	941	113	yes	390518	-
9530	scaffold_13	478324	479219	895	101	yes	314739	+
9531	scaffold_13	484733	485641	908	90	yes	413760	-
9532	scaffold_13	493407	494383	976	135	yes	230478	-
9533	scaffold_13	498482	500031	1549	143	yes	34541	+
9534	scaffold_13	518711	520242	1531	158	yes	314755	-
9535	scaffold_13	521875	522652	777	95	no	NA	NA
9536	scaffold_13	523049	524536	1487	136	yes	314760	+
9537	scaffold_13	529279	530762	1483	167	yes	292756	-
9538	scaffold_13	532032	534005	1973	223	yes	314763,390526	-,+
9539	scaffold_13	534356	535563	1207	137	yes	314763,390526	-,+
9540	scaffold_13	539326	540402	1076	105	yes	423877	+
9541	scaffold_13	542192	543844	1652	216	yes	314768	+
9542	scaffold_13	547345	548316	971	92	yes	314771	+
9543	scaffold_13	552904	554009	1105	99	yes	314774	+
9544	scaffold_13	557100	558128	1028	129	yes	314776	+
9545	scaffold_13	560638	561410	772	84	yes	314779	-
9546	scaffold_13	563199	564343	1144	134	yes	230502	-
9547	scaffold_13	576160	577285	1125	130	yes	314789	+
9548	scaffold_13	589783	590871	1088	95	yes	390537	-
9549	scaffold_13	591607	592815	1208	168	yes	423888	+
9550	scaffold_13	599071	600924	1853	193	yes	35017	-
9551	scaffold_13	602517	602568	51	7	no	NA	NA
9552	scaffold_13	602847	603761	914	120	yes	314796	-
9553	scaffold_13	606322	607747	1425	144	yes	314800	-
9554	scaffold_13	610603	611827	1224	118	yes	314801	-
9555	scaffold_13	625721	626987	1266	141	no	NA	NA
9556	scaffold_13	634991	636316	1325	118	yes	314812,314814	-,+
9557	scaffold_13	636928	638299	1371	187	yes	314815	+
9558	scaffold_13	643726	643733	7	4	no	NA	NA
9559	scaffold_13	643845	645193	1348	198	yes	314819	-
9560	scaffold_13	650087	651067	980	76	yes	423900	+
9561	scaffold_13	654682	655371	689	48	no	NA	NA
9562	scaffold_13	658783	660157	1374	114	yes	413797	+
9563	scaffold_13	709180	710714	1534	131	no	NA	NA
9564	scaffold_13	715763	716703	940	100	yes	423911	+
9565	scaffold_13	716793	716824	31	8	no	NA	NA
9566	scaffold_13	720468	722226	1758	182	yes	390561	+
9567	scaffold_13	726253	727367	1114	124	yes	314865	+
9568	scaffold_13	732453	733980	1527	211	yes	35323	+
9569	scaffold_13	748348	748969	621	61	no	NA	NA
9570	scaffold_13	749472	751939	2467	241	yes	314876	+
9571	scaffold_13	756685	757681	996	96	no	NA	NA
9572	scaffold_13	763964	765313	1349	99	yes	35379	-
9573	scaffold_13	768659	769848	1189	135	yes	423922	+
9574	scaffold_13	782083	783176	1093	107	yes	314892	-
9575	scaffold_13	783775	784857	1082	120	yes	314893	+
9576	scaffold_13	786711	788513	1802	163	yes	314896,413829	-,+
9577	scaffold_13	792155	793480	1325	160	no	NA	NA
9578	scaffold_13	793619	793987	368	50	no	NA	NA
9579	scaffold_13	797111	798325	1214	180	yes	423928	-
9580	scaffold_13	810140	810750	610	58	no	NA	NA
9581	scaffold_13	811273	811934	661	92	yes	35536	+
9582	scaffold_13	814187	815453	1266	143	yes	314912	+
9583	scaffold_13	818492	819872	1380	168	yes	314915	-
9584	scaffold_13	820535	821916	1381	191	yes	314917	+
9585	scaffold_13	825761	826834	1073	90	yes	230564	-
9586	scaffold_13	828120	829162	1042	109	yes	314919	-
9587	scaffold_13	834708	835959	1251	154	yes	314922	-
9588	scaffold_13	836756	838286	1530	189	yes	314925	+
9589	scaffold_13	850467	850474	7	4	no	NA	NA
9590	scaffold_13	850657	851873	1216	168	yes	413844	-
9591	scaffold_13	852295	853471	1176	140	yes	314929	-
9592	scaffold_13	854664	855895	1231	148	yes	243121	+
9593	scaffold_13	858866	860203	1337	144	yes	314932	+
9594	scaffold_13	861285	862345	1060	108	yes	423945	+
9595	scaffold_13	862473	862584	111	4	no	NA	NA
9596	scaffold_13	870851	872354	1503	185	yes	413850	-
9597	scaffold_13	872656	874749	2093	255	yes	314944	-
9598	scaffold_13	876363	877342	979	125	yes	314947	-
9599	scaffold_13	879092	879877	785	66	yes	314948	+
9600	scaffold_13	887547	888624	1077	128	yes	423952	+
9601	scaffold_13	894191	895324	1133	98	yes	390603	+
9602	scaffold_13	898579	899741	1162	119	yes	390604	+
9603	scaffold_13	908286	909853	1567	168	yes	314965	-
9604	scaffold_13	912443	913931	1488	198	yes	292848,314970	-,+
9605	scaffold_13	914137	915223	1086	115	yes	314970	+
9606	scaffold_13	917818	918910	1092	91	yes	314972	-
9607	scaffold_13	919410	919835	425	36	no	NA	NA
9608	scaffold_13	923447	924277	830	51	yes	413864	-
9609	scaffold_13	927880	928865	985	115	yes	314974	+
9610	scaffold_13	928990	929002	12	3	no	NA	NA
9611	scaffold_13	933518	934607	1089	160	yes	413866	-
9612	scaffold_13	935476	936734	1258	137	yes	413867	+
9613	scaffold_13	948477	948614	137	30	yes	314990	+
9614	scaffold_13	949216	950565	1349	150	yes	314990	+
9615	scaffold_13	952009	953171	1162	153	yes	314992	+
9616	scaffold_13	970669	971933	1264	170	yes	314999	-
9617	scaffold_13	974542	975727	1185	95	yes	390617	+
9618	scaffold_13	978364	979012	648	57	no	NA	NA
9619	scaffold_13	989316	990836	1520	157	yes	315019	-
9620	scaffold_13	993377	994290	913	100	yes	315021	-
9621	scaffold_13	995936	996350	414	44	yes	315023	-
9622	scaffold_13	1001884	1003220	1336	166	yes	423972	+
9623	scaffold_13	1007634	1008135	501	55	yes	390622	-
9624	scaffold_13	1010417	1011027	610	68	yes	315031	+
9625	scaffold_13	1015997	1017259	1262	154	no	NA	NA
9626	scaffold_13	1030270	1030317	47	6	no	NA	NA
9627	scaffold_13	1030445	1031509	1064	124	yes	315042	-
9628	scaffold_13	1032863	1033536	673	63	yes	315043	+
9629	scaffold_13	1033703	1033792	89	4	no	NA	NA
9630	scaffold_13	1042933	1044341	1408	162	yes	36330	+
9631	scaffold_13	1059136	1060345	1209	85	no	NA	NA
9632	scaffold_13	1064268	1065235	967	127	yes	315055	+
9633	scaffold_13	1075826	1076974	1148	117	yes	390633	-
9634	scaffold_13	1079324	1080514	1190	162	yes	243166	-
9635	scaffold_13	1081119	1081145	26	5	no	NA	NA
9636	scaffold_13	1087540	1088135	595	52	yes	390636	+
9637	scaffold_13	1088348	1088370	22	8	no	NA	NA
9638	scaffold_13	1090809	1091830	1021	127	yes	36475	+
9639	scaffold_13	1094537	1095497	960	108	yes	315074,423990	+,-
9640	scaffold_13	1095937	1097035	1098	111	yes	315074,423990	+,-
9641	scaffold_13	1105275	1105374	99	16	yes	423993	+
9642	scaffold_13	1113243	1114673	1430	116	no	NA	NA
9643	scaffold_13	1123080	1124561	1481	137	no	NA	NA
9644	scaffold_13	1126176	1127137	961	98	yes	423996	+
9645	scaffold_13	1154218	1155259	1041	117	yes	424001	+
9646	scaffold_13	1155502	1155558	56	10	yes	424001	+
9647	scaffold_13	1164328	1165381	1053	82	yes	292902	+
9648	scaffold_13	1168981	1170215	1234	142	yes	424003	+
9649	scaffold_13	1171046	1172441	1395	194	yes	315102	+
9650	scaffold_13	1177429	1178525	1096	89	yes	390652	-
9651	scaffold_13	1180260	1180280	20	6	yes	36679	-
9652	scaffold_13	1180377	1180436	59	14	yes	36679	-
9653	scaffold_13	1180577	1180593	16	4	yes	36679	-
9654	scaffold_13	1180802	1181211	409	18	yes	36679	-
9655	scaffold_13	1186320	1187398	1078	146	yes	315108	+
9656	scaffold_13	1192070	1193922	1852	154	yes	292907	+
9657	scaffold_13	1199175	1200333	1158	120	yes	424009	-
9658	scaffold_13	1220315	1220660	345	42	yes	315122	+
9659	scaffold_13	1220745	1220801	56	16	yes	315122	+
9660	scaffold_13	1221095	1222259	1164	145	yes	315122	+
9661	scaffold_13	1233272	1234947	1675	202	no	NA	NA
9662	scaffold_13	1239977	1241294	1317	138	yes	292916	-
9663	scaffold_13	1243490	1244903	1413	183	yes	390664	-
9664	scaffold_13	1250232	1251399	1167	146	yes	390666	-
9665	scaffold_13	1254117	1255625	1508	157	yes	292921	-
9666	scaffold_13	1256331	1257609	1278	147	yes	315143	-
9667	scaffold_13	1258284	1259439	1155	130	yes	315147	+
9668	scaffold_13	1261958	1262879	921	112	yes	413941	-
9669	scaffold_13	1265628	1266920	1292	131	yes	292925	+
9670	scaffold_13	1274500	1274924	424	24	yes	36916	-
9671	scaffold_13	1278832	1280029	1197	143	yes	365503	+
9672	scaffold_13	1283710	1285243	1533	166	yes	413945	-
9673	scaffold_13	1285882	1286500	618	41	no	NA	NA
9674	scaffold_13	1289186	1290234	1048	81	yes	413946	-
9675	scaffold_13	1293150	1294053	903	120	yes	315156,315157	+,+
9676	scaffold_13	1294238	1295045	807	68	yes	315157	+
9677	scaffold_13	1297004	1298143	1139	126	yes	315158	-
9678	scaffold_130	7580	8089	509	51	yes	398975	+
9679	scaffold_130	15917	16186	269	30	yes	432532	-
9680	scaffold_130	21612	21919	307	37	yes	336326	-
9681	scaffold_130	41728	42788	1060	130	yes	303366	-
9682	scaffold_130	59213	59455	242	22	yes	413538	+
9683	scaffold_130	59517	59606	89	13	yes	413538	+
9684	scaffold_130	66560	67880	1320	63	yes	413541	-
9685	scaffold_130	68129	68700	571	43	no	NA	NA
9686	scaffold_150	41729	41910	181	23	no	NA	NA
9687	scaffold_150	42051	42060	9	4	no	NA	NA
9688	scaffold_150	42267	42443	176	23	no	NA	NA
9689	scaffold_150	42584	42593	9	4	no	NA	NA
9690	scaffold_150	42830	42846	16	4	no	NA	NA
9691	scaffold_307	2314	2716	402	25	no	NA	NA
9692	scaffold_307	9616	9678	62	6	no	NA	NA
9693	scaffold_64	8805	9549	744	111	no	NA	NA
9694	scaffold_64	34521	35011	490	19	yes	300599	-
9695	scaffold_64	36106	36348	242	12	no	NA	NA
9696	scaffold_64	44634	46303	1669	253	no	NA	NA
9697	scaffold_64	54210	55135	925	78	yes	300601	+
9698	scaffold_64	55289	55402	113	15	yes	300601	+
9699	scaffold_64	70212	71345	1133	80	yes	430322	-
9700	scaffold_64	76147	76721	574	88	yes	160685	-
9701	scaffold_64	79593	80388	795	63	yes	330707	-
9702	scaffold_64	81546	82137	591	60	yes	330709	-
9703	scaffold_64	85710	87209	1499	127	yes	300607	-
9704	scaffold_64	97105	98292	1187	192	yes	330716	+
9705	scaffold_64	117197	118502	1305	152	no	NA	NA
9706	scaffold_64	121687	122969	1282	134	yes	396845	+
9707	scaffold_64	126282	128047	1765	157	yes	330728	+
9708	scaffold_64	140360	141672	1312	138	yes	198938	-
9709	scaffold_64	163785	164793	1008	97	yes	330735	+
9710	scaffold_64	171338	172505	1167	128	yes	330737	-
9711	scaffold_64	194814	195977	1163	138	yes	248953	-
9712	scaffold_64	200066	201061	995	79	yes	300631	+
9713	scaffold_64	201340	201352	12	4	yes	300631	+
9714	scaffold_64	209484	210710	1226	156	yes	160928	-
9715	scaffold_64	213080	214283	1203	164	yes	330748	-
9716	scaffold_64	222849	224142	1293	172	yes	330752	+
9717	scaffold_64	231407	231900	493	40	yes	380227	+
9718	scaffold_64	238384	239656	1272	127	yes	330758	+
9719	scaffold_64	246862	248234	1372	140	yes	396869	+
9720	scaffold_64	256189	257187	998	116	yes	161082	+
9721	scaffold_64	262858	263815	957	80	yes	330762	-
9722	scaffold_64	264789	265999	1210	130	yes	430359	+
9723	scaffold_64	267089	268359	1270	87	no	NA	NA
9724	scaffold_64	272263	273642	1379	147	yes	366365	+
9725	scaffold_64	279970	281044	1074	110	yes	330770,430362	+,-
9726	scaffold_64	281510	282659	1149	139	yes	330770,430362	+,-
9727	scaffold_64	286095	287336	1241	134	yes	330773	+
9728	scaffold_64	289005	290448	1443	157	yes	330775	-
9729	scaffold_64	294790	295988	1198	145	yes	330779	+
9730	scaffold_64	296112	296124	12	3	no	NA	NA
9731	scaffold_64	297569	298634	1065	102	yes	300651	-
9732	scaffold_64	299080	300106	1026	111	yes	300651,330782	-,+
9733	scaffold_64	304747	305915	1168	209	yes	330788	-
9734	scaffold_64	307452	309559	2107	208	yes	430370	+
9735	scaffold_64	309711	309721	10	4	no	NA	NA
9736	scaffold_64	316028	316770	742	59	yes	330793	-
9737	scaffold_64	318128	319129	1001	117	yes	330794	-
9738	scaffold_64	320909	321423	514	49	yes	402517	+
9739	scaffold_64	325108	325808	700	45	no	NA	NA
9740	scaffold_64	331291	331472	181	24	yes	330801	+
9741	scaffold_64	341356	342106	750	66	yes	430376	+
9742	scaffold_64	349962	350719	757	74	no	NA	NA
9743	scaffold_64	363723	364068	345	38	yes	300665	+
9744	scaffold_64	369953	371270	1317	167	no	NA	NA
9745	scaffold_64	379864	380973	1109	142	no	NA	NA
9746	scaffold_64	383078	384330	1252	100	yes	330820	+
9747	scaffold_64	395828	397344	1516	147	yes	330823	+
9748	scaffold_64	420306	421184	878	110	yes	330830	+
9749	scaffold_64	431354	431990	636	75	no	NA	NA
9750	scaffold_64	439285	439303	18	4	no	NA	NA
9751	scaffold_94	34545	35564	1019	170	yes	418019	+
9752	scaffold_94	64857	66212	1355	162	no	NA	NA
9753	scaffold_94	66761	67196	435	50	yes	398201	+
9754	scaffold_94	68747	69970	1223	132	yes	334108	+
9755	scaffold_94	74217	75607	1390	147	no	NA	NA
9756	scaffold_94	76934	78027	1093	92	yes	334113	-
9757	scaffold_94	83737	84941	1204	92	yes	334114	+
9758	scaffold_94	85542	85551	9	4	no	NA	NA
9759	scaffold_94	92266	92314	48	14	no	NA	NA
9760	scaffold_94	92601	94707	2106	97	yes	224968	-
9761	scaffold_94	99662	100833	1171	109	yes	334122	+
9762	scaffold_94	104546	105502	956	144	yes	334125,334128	-,+
9763	scaffold_94	105825	106980	1155	124	yes	334125,334128	-,+
9764	scaffold_94	109160	109164	4	4	no	NA	NA
9765	scaffold_94	110296	111354	1058	90	yes	302327	+
9766	scaffold_94	114065	114854	789	94	yes	193806	+
9767	scaffold_94	116356	118319	1963	202	yes	418040	+
9768	scaffold_94	132681	133801	1120	132	yes	431737	-
9769	scaffold_94	141913	143009	1096	167	yes	193887,398216	-,+
9770	scaffold_94	143312	144589	1277	156	yes	193887,398216	-,+
9771	scaffold_94	147183	148389	1206	127	yes	431741	-
9772	scaffold_94	151474	151657	183	16	yes	302338	+
9773	scaffold_94	156131	157029	898	98	yes	334152	+
9774	scaffold_94	159946	160498	552	64	yes	334156	-
9775	scaffold_94	161642	161649	7	4	no	NA	NA
9776	scaffold_94	166992	168386	1394	204	yes	418051	+
9777	scaffold_94	177528	178674	1146	106	yes	334164	-
9778	scaffold_94	183112	185344	2232	273	no	NA	NA
9779	scaffold_94	199680	200849	1169	174	yes	334178	-
9780	scaffold_94	202969	203745	776	71	yes	237860	+
9781	scaffold_94	206577	207563	986	133	yes	334181	+
9782	scaffold_129	17591	18643	1052	153	no	NA	NA
9783	scaffold_129	18880	19289	409	70	no	NA	NA
9784	scaffold_129	19405	19600	195	26	no	NA	NA
9785	scaffold_129	22985	22997	12	4	no	NA	NA
9786	scaffold_129	24723	24775	52	5	no	NA	NA
9787	scaffold_129	24963	25219	256	48	no	NA	NA
9788	scaffold_129	25455	25483	28	6	yes	432525	-
9789	scaffold_129	25624	25967	343	30	yes	432525	-
9790	scaffold_129	28104	28108	4	4	yes	398973	+
9791	scaffold_129	28460	28467	7	4	yes	398973	+
9792	scaffold_129	55240	55284	44	12	no	NA	NA
9793	scaffold_129	58338	58409	71	13	no	NA	NA
9794	scaffold_129	58736	58781	45	12	no	NA	NA
9795	scaffold_129	61114	61496	382	34	no	NA	NA
9796	scaffold_129	64798	64843	45	10	no	NA	NA
9797	scaffold_129	67823	67897	74	14	no	NA	NA
9798	scaffold_129	67979	68443	464	60	no	NA	NA
9799	scaffold_129	68731	69009	278	50	no	NA	NA
9800	scaffold_129	69308	69331	23	6	no	NA	NA
9801	scaffold_129	79882	79941	59	11	no	NA	NA
9802	scaffold_147	3260	4294	1034	108	yes	41759	+
9803	scaffold_147	48634	48647	13	3	no	NA	NA
9804	scaffold_147	49126	49144	18	3	no	NA	NA
9805	scaffold_250	1902	3119	1217	108	no	NA	NA
9806	scaffold_250	6605	6623	18	5	no	NA	NA
9807	scaffold_308	10562	10580	18	4	no	NA	NA
9808	scaffold_93	5994	6640	646	75	no	NA	NA
9809	scaffold_93	16981	17240	259	23	yes	302264	+
9810	scaffold_93	25796	26937	1141	127	yes	334011	-
9811	scaffold_93	29452	30379	927	98	yes	334014,431690	-,+
9812	scaffold_93	30654	32127	1473	159	yes	334014,431690	-,+
9813	scaffold_93	39155	40118	963	118	yes	334020	+
9814	scaffold_93	42582	43452	870	100	no	NA	NA
9815	scaffold_93	52804	53695	891	39	yes	398167	-
9816	scaffold_93	62569	63514	945	108	yes	193284	+
9817	scaffold_93	80205	80941	736	108	yes	408937	+
9818	scaffold_93	83234	83772	538	60	yes	193316	+
9819	scaffold_93	93648	94041	393	47	yes	398174	+
9820	scaffold_93	101360	102187	827	129	yes	334034	-
9821	scaffold_93	106174	107774	1600	153	yes	334038	+
9822	scaffold_93	110355	110818	463	37	yes	398177	+
9823	scaffold_93	112759	113958	1199	118	yes	334042	+
9824	scaffold_93	128515	129792	1277	165	yes	398179	+
9825	scaffold_93	134345	134703	358	50	yes	382950	-
9826	scaffold_93	152544	153293	749	84	yes	398184	+
9827	scaffold_93	161385	162233	848	112	yes	334059	+
9828	scaffold_93	166471	167577	1106	128	yes	334061	+
9829	scaffold_93	170328	171663	1335	147	yes	193466	+
9830	scaffold_93	227032	227644	612	48	no	NA	NA
9831	scaffold_93	227942	228057	115	16	no	NA	NA
9832	scaffold_93	233970	234129	159	14	yes	398194	-
9833	scaffold_128	2829	2929	100	24	no	NA	NA
9834	scaffold_128	3059	3190	131	21	no	NA	NA
9835	scaffold_128	3270	3307	37	9	no	NA	NA
9836	scaffold_128	5017	5048	31	10	no	NA	NA
9837	scaffold_128	8802	8905	103	8	no	NA	NA
9838	scaffold_128	9112	9657	545	53	no	NA	NA
9839	scaffold_128	9781	9880	99	11	no	NA	NA
9840	scaffold_128	16321	16354	33	8	no	NA	NA
9841	scaffold_128	16454	16482	28	8	no	NA	NA
9842	scaffold_128	16641	16697	56	8	no	NA	NA
9843	scaffold_128	16834	17053	219	25	no	NA	NA
9844	scaffold_128	19577	20044	467	47	no	NA	NA
9845	scaffold_128	21537	21552	15	8	no	NA	NA
9846	scaffold_128	21664	22078	414	32	no	NA	NA
9847	scaffold_128	26935	26958	23	7	no	NA	NA
9848	scaffold_128	27283	27301	18	6	no	NA	NA
9849	scaffold_128	27474	27535	61	14	no	NA	NA
9850	scaffold_128	27748	28940	1192	80	no	NA	NA
9851	scaffold_128	29072	29487	415	25	yes	369015	+
9852	scaffold_128	31000	31031	31	10	no	NA	NA
9853	scaffold_128	31390	31425	35	4	no	NA	NA
9854	scaffold_128	34210	34241	31	10	no	NA	NA
9855	scaffold_128	41487	41609	122	12	no	NA	NA
9856	scaffold_128	45796	46454	658	91	no	NA	NA
9857	scaffold_128	46559	47645	1086	119	yes	32812,369024	-,+
9858	scaffold_128	52109	52115	6	4	no	NA	NA
9859	scaffold_128	52252	52271	19	6	no	NA	NA
9860	scaffold_128	52749	53302	553	64	no	NA	NA
9861	scaffold_128	54106	54179	73	16	no	NA	NA
9862	scaffold_128	54260	54469	209	31	no	NA	NA
9863	scaffold_128	54713	55144	431	33	yes	336286	+
9864	scaffold_128	55585	56348	763	67	yes	336286	+
9865	scaffold_128	70486	70495	9	4	no	NA	NA
9866	scaffold_128	76184	76303	119	18	yes	432523	-
9867	scaffold_128	76408	76657	249	12	yes	432523	-
9868	scaffold_128	76762	77060	298	26	no	NA	NA
9869	scaffold_128	77180	77219	39	10	no	NA	NA
9870	scaffold_128	81626	81684	58	12	no	NA	NA
9871	scaffold_128	81811	81832	21	8	no	NA	NA
9872	scaffold_128	81913	82013	100	13	no	NA	NA
9873	scaffold_128	82072	82426	354	48	no	NA	NA
9874	scaffold_128	82533	83404	871	80	yes	32879	-
9875	scaffold_128	83884	84108	224	13	no	NA	NA
9876	scaffold_128	84293	84480	187	9	no	NA	NA
9877	scaffold_148	7914	9112	1198	110	yes	414577	+
9878	scaffold_209	4079	4098	19	6	no	NA	NA
9879	scaffold_209	7306	7325	19	6	no	NA	NA
9880	scaffold_209	15257	15276	19	6	no	NA	NA
9881	scaffold_209	18511	18530	19	5	no	NA	NA
9882	scaffold_209	19007	19020	13	3	no	NA	NA
9883	scaffold_92	996	1034	38	8	no	NA	NA
9884	scaffold_92	4147	4190	43	7	no	NA	NA
9885	scaffold_92	4668	4687	19	7	no	NA	NA
9886	scaffold_92	12379	12393	14	6	no	NA	NA
9887	scaffold_92	23443	24392	949	98	yes	333940	-
9888	scaffold_92	35228	35236	8	4	yes	333944	-
9889	scaffold_92	64108	65005	897	80	no	NA	NA
9890	scaffold_92	71344	72391	1047	106	yes	398130	-
9891	scaffold_92	78810	79604	794	69	yes	431652	+
9892	scaffold_92	138442	139622	1180	129	no	NA	NA
9893	scaffold_92	145398	146499	1101	138	yes	431667	-
9894	scaffold_92	158932	159803	871	90	yes	237783	-
9895	scaffold_92	161742	162349	607	64	no	NA	NA
9896	scaffold_92	188348	189353	1005	99	no	NA	NA
9897	scaffold_92	197067	198000	933	78	yes	431677	+
9898	scaffold_92	220772	220797	25	6	yes	431681	-
9899	scaffold_126	32893	33123	230	52	no	NA	NA
9900	scaffold_126	89202	89221	19	6	no	NA	NA
9901	scaffold_126	92414	92432	18	5	no	NA	NA
9902	scaffold_154	42771	43265	494	69	no	NA	NA
9903	scaffold_202	770	852	82	9	no	NA	NA
9904	scaffold_202	8801	9548	747	105	no	NA	NA
9905	scaffold_202	9677	10004	327	27	no	NA	NA
9906	scaffold_162	8835	8857	22	8	no	NA	NA
9907	scaffold_162	8965	9013	48	14	no	NA	NA
9908	scaffold_162	9113	9327	214	28	no	NA	NA
9909	scaffold_162	15972	16729	757	58	yes	399149	+
9910	scaffold_65	74951	74970	19	8	no	NA	NA
9911	scaffold_65	75451	75465	14	6	no	NA	NA
9912	scaffold_65	114160	114191	31	10	no	NA	NA
9913	scaffold_65	114299	114374	75	22	no	NA	NA
9914	scaffold_65	114482	114522	40	12	no	NA	NA
9915	scaffold_65	114630	114652	22	8	no	NA	NA
9916	scaffold_65	169348	169367	19	6	no	NA	NA
9917	scaffold_65	180393	181362	969	107	yes	330852,330854	-,+
9918	scaffold_65	181606	182164	558	50	yes	330852,330854	-,+
9919	scaffold_65	183495	184533	1038	126	yes	396913	+
9920	scaffold_65	191102	192808	1706	161	yes	430396	-
9921	scaffold_65	194447	195702	1255	129	yes	330857	-
9922	scaffold_65	206106	208028	1922	225	yes	396918	-
9923	scaffold_65	219179	220545	1366	172	yes	223653,330866	+,-
9924	scaffold_65	221276	222584	1308	171	yes	330869	+
9925	scaffold_65	225702	226656	954	97	yes	430404	+
9926	scaffold_65	234578	234801	223	14	yes	430407	-
9927	scaffold_65	253170	253320	150	14	no	NA	NA
9928	scaffold_65	287581	288608	1027	81	yes	223657	-
9929	scaffold_65	293065	294546	1481	115	yes	300704	-
9930	scaffold_65	301461	302595	1134	85	yes	330888	-
9931	scaffold_65	306223	307197	974	147	yes	330892	+
9932	scaffold_65	308895	310480	1585	189	yes	161904	+
9933	scaffold_65	320586	321634	1048	116	yes	330898	-
9934	scaffold_65	336534	336553	19	7	no	NA	NA
9935	scaffold_91	6281	6329	48	12	no	NA	NA
9936	scaffold_91	22033	22733	700	83	yes	250059	-
9937	scaffold_91	30599	31838	1239	106	yes	431600	+
9938	scaffold_91	33499	34733	1234	143	no	NA	NA
9939	scaffold_91	38665	39406	741	104	no	NA	NA
9940	scaffold_91	39720	39954	234	34	no	NA	NA
9941	scaffold_91	47345	48838	1493	180	yes	431602	-
9942	scaffold_91	49204	49231	27	8	no	NA	NA
9943	scaffold_91	49905	51270	1365	171	yes	333864	+
9944	scaffold_91	61378	62153	775	73	yes	224852	-
9945	scaffold_91	71364	73216	1852	240	yes	333872	-
9946	scaffold_91	89060	89840	780	70	yes	333876	+
9947	scaffold_91	92944	93770	826	87	yes	192345	+
9948	scaffold_91	93886	93949	63	12	no	NA	NA
9949	scaffold_91	97731	99012	1281	130	yes	192352	+
9950	scaffold_91	109363	110880	1517	208	yes	333889,398093	+,+
9951	scaffold_91	111103	112191	1088	119	yes	398093	+
9952	scaffold_91	144748	146083	1335	140	yes	333893	+
9953	scaffold_91	148441	149406	965	134	yes	333896	-
9954	scaffold_91	150785	151754	969	102	yes	431621	-
9955	scaffold_91	158452	159907	1455	164	yes	431622	-
9956	scaffold_91	162199	163071	872	124	yes	333901	-
9957	scaffold_91	165749	166918	1169	177	yes	224828	-
9958	scaffold_91	168096	169263	1167	136	yes	250089	-
9959	scaffold_91	170637	170647	10	4	no	NA	NA
9960	scaffold_91	171078	172504	1426	104	yes	333906	-
9961	scaffold_91	194578	195365	787	22	no	NA	NA
9962	scaffold_91	204824	205805	981	110	yes	399715	-
9963	scaffold_91	210164	211611	1447	164	yes	431629	+
9964	scaffold_91	219915	221130	1215	106	yes	192742	-
9965	scaffold_91	222224	223119	895	95	no	NA	NA
9966	scaffold_91	228271	229498	1227	171	yes	333917	-
9967	scaffold_91	233507	234850	1343	137	no	NA	NA
9968	scaffold_91	237638	238908	1270	146	yes	333922	-
9969	scaffold_91	239998	241362	1364	137	yes	399723	+
9970	scaffold_118	25809	26098	289	40	yes	432376	+
9971	scaffold_118	44627	44973	346	34	yes	335968	+
9972	scaffold_118	48787	48855	68	19	no	NA	NA
9973	scaffold_118	50044	50112	68	19	no	NA	NA
9974	scaffold_118	52846	52873	27	8	yes	432379	-
9975	scaffold_118	52954	53172	218	23	yes	432379	-
9976	scaffold_118	54214	54606	392	34	no	NA	NA
9977	scaffold_118	54810	56425	1615	206	no	NA	NA
9978	scaffold_118	64006	66174	2168	245	yes	401660	+
9979	scaffold_118	66378	66732	354	35	no	NA	NA
9980	scaffold_118	69354	70598	1244	158	yes	303166,401662	+,+
9981	scaffold_118	76404	76487	83	14	no	NA	NA
9982	scaffold_118	76593	76670	77	20	no	NA	NA
9983	scaffold_118	77384	77444	60	18	no	NA	NA
9984	scaffold_118	78478	78499	21	5	no	NA	NA
9985	scaffold_118	81230	81290	60	16	yes	401667	+
9986	scaffold_118	95227	95286	59	14	no	NA	NA
9987	scaffold_118	96271	96340	69	18	no	NA	NA
9988	scaffold_118	104881	104941	60	12	no	NA	NA
9989	scaffold_118	105058	105113	55	14	no	NA	NA
9990	scaffold_118	105235	105280	45	9	no	NA	NA
9991	scaffold_66	43811	44743	932	104	yes	236678	-
9992	scaffold_66	47436	47447	11	4	no	NA	NA
9993	scaffold_66	61387	62150	763	42	yes	236685	+
9994	scaffold_66	67229	67872	643	50	yes	430432	+
9995	scaffold_66	80989	81013	24	4	yes	396945	-
9996	scaffold_66	81202	81981	779	72	yes	396945	-
9997	scaffold_66	90421	90439	18	7	no	NA	NA
9998	scaffold_66	118901	119857	956	91	yes	330950	+
9999	scaffold_66	125980	127131	1151	149	yes	330962	-
10000	scaffold_66	128151	129020	869	118	yes	330965	+
10001	scaffold_66	132888	134242	1354	142	yes	430439	-
10002	scaffold_66	158859	160435	1576	181	yes	330980	-
10003	scaffold_66	173439	173743	304	13	no	NA	NA
10004	scaffold_66	173895	174229	334	35	no	NA	NA
10005	scaffold_66	174664	175219	555	43	no	NA	NA
10006	scaffold_66	176363	176401	38	5	no	NA	NA
10007	scaffold_66	176805	177073	268	25	no	NA	NA
10008	scaffold_66	179986	183848	3862	487	no	NA	NA
10009	scaffold_66	193967	193996	29	10	no	NA	NA
10010	scaffold_66	196991	198917	1926	204	yes	330991	+
10011	scaffold_66	201448	202657	1209	90	yes	330998	+
10012	scaffold_66	221338	222842	1504	130	yes	331010	-
10013	scaffold_66	273960	274640	680	71	yes	300768	-
10014	scaffold_66	276702	278232	1530	175	yes	331031	+
10015	scaffold_66	288968	290380	1412	127	yes	331042	-
10016	scaffold_66	290649	291978	1329	119	yes	331042,331044	-,-
10017	scaffold_66	298728	299556	828	98	yes	331045	-
10018	scaffold_66	304165	305198	1033	96	yes	331052	-
10019	scaffold_66	305985	308149	2164	161	yes	331060	-
10020	scaffold_66	310456	312652	2196	212	yes	430468	-
10021	scaffold_66	317763	317867	104	12	no	NA	NA
10022	scaffold_66	318105	318991	886	66	yes	396986	-
10023	scaffold_66	324438	324451	13	4	no	NA	NA
10024	scaffold_66	325110	325939	829	103	yes	162683	-
10025	scaffold_66	327369	328631	1262	137	yes	331065	-
10026	scaffold_66	333126	333897	771	68	yes	331068	-
10027	scaffold_66	338704	338843	139	10	no	NA	NA
10028	scaffold_66	339051	339071	20	6	no	NA	NA
10029	scaffold_66	339199	340193	994	87	yes	236711	-
10030	scaffold_66	341839	343507	1668	210	yes	331075,411284	+,-
10031	scaffold_66	343781	345017	1236	124	yes	331075	+
10032	scaffold_66	347820	348366	546	36	yes	430476	-
10033	scaffold_66	358912	359424	512	48	yes	331080	-
10034	scaffold_66	361564	362364	800	82	yes	331083	+
10035	scaffold_66	364096	365341	1245	115	no	NA	NA
10036	scaffold_66	366195	367102	907	88	yes	331085	+
10037	scaffold_66	373914	374378	464	54	yes	396998	-
10038	scaffold_124	11778	12710	932	77	yes	402870	+
10039	scaffold_124	12859	12887	28	4	no	NA	NA
10040	scaffold_124	18639	19211	572	51	yes	32294	+
10041	scaffold_124	30277	31069	792	52	yes	32309	-
10042	scaffold_124	32794	32814	20	6	no	NA	NA
10043	scaffold_124	36037	37009	972	129	yes	32312	-
10044	scaffold_124	44901	45990	1089	166	no	NA	NA
10045	scaffold_124	46216	46223	7	4	no	NA	NA
10046	scaffold_124	52681	52712	31	4	no	NA	NA
10047	scaffold_124	52960	53841	881	101	yes	336174	-
10048	scaffold_124	67736	67958	222	15	no	NA	NA
10049	scaffold_124	74366	75507	1141	95	no	NA	NA
10050	scaffold_124	79475	79499	24	8	no	NA	NA
10051	scaffold_124	91206	91249	43	10	no	NA	NA
10052	scaffold_124	91912	93070	1158	100	no	NA	NA
10053	scaffold_199	3146	3175	29	5	no	NA	NA
10054	scaffold_199	3485	3490	5	3	no	NA	NA
10055	scaffold_266	4564	4578	14	6	no	NA	NA
10056	scaffold_266	5056	5075	19	6	no	NA	NA
10057	scaffold_316	1401	3100	1699	134	yes	102491	+
10058	scaffold_67	6703	7556	853	67	yes	300799	+
10059	scaffold_67	7822	7855	33	8	no	NA	NA
10060	scaffold_67	11582	13193	1611	158	yes	300801,331106	+,-
10061	scaffold_67	15431	16991	1560	183	yes	331113	+
10062	scaffold_67	17909	18768	859	80	yes	331115,397009	-,+
10063	scaffold_67	19109	20085	976	99	yes	331115,397009	-,+
10064	scaffold_67	37758	38824	1066	95	yes	331119	+
10065	scaffold_67	43149	44287	1138	151	yes	331121	+
10066	scaffold_67	46283	47190	907	89	yes	397015	-
10067	scaffold_67	49311	50402	1091	100	yes	331124	-
10068	scaffold_67	50798	51955	1157	124	yes	331124,331127	-,-
10069	scaffold_67	53897	55247	1350	152	yes	162990,162992	-,-
10070	scaffold_67	57357	58692	1335	180	yes	163009,397019	+,-
10071	scaffold_67	65660	67504	1844	185	yes	331137	-
10072	scaffold_67	69539	70951	1412	175	yes	331144	-
10073	scaffold_67	76319	77455	1136	151	yes	331150	-
10074	scaffold_67	81351	81373	22	4	no	NA	NA
10075	scaffold_67	81592	82210	618	45	yes	430511	-
10076	scaffold_67	90324	91593	1269	141	yes	163123	+
10077	scaffold_67	99985	101471	1486	200	yes	331162	-
10078	scaffold_67	124753	124802	49	6	no	NA	NA
10079	scaffold_67	125010	126272	1262	144	no	NA	NA
10080	scaffold_67	128914	129528	614	85	yes	331175	+
10081	scaffold_67	131146	133261	2115	232	yes	331177	+
10082	scaffold_67	135790	136613	823	84	yes	300835	+
10083	scaffold_67	141612	142812	1200	86	yes	430522	+
10084	scaffold_67	144757	146206	1449	173	yes	397039	+
10085	scaffold_67	151010	153368	2358	273	yes	405497	-
10086	scaffold_67	158076	158975	899	108	yes	331188,405498	+,-
10087	scaffold_67	159436	160065	629	81	yes	331188,405498	+,-
10088	scaffold_67	162931	164624	1693	213	yes	163353	+
10089	scaffold_67	166660	168016	1356	174	yes	331194	-
10090	scaffold_67	175059	176394	1335	148	yes	405502	-
10091	scaffold_67	177734	178526	792	96	no	NA	NA
10092	scaffold_67	180090	181486	1396	115	yes	405504	+
10093	scaffold_67	191879	191935	56	12	no	NA	NA
10094	scaffold_67	193189	194649	1460	161	yes	331214	+
10095	scaffold_67	199748	201217	1469	144	yes	405508	+
10096	scaffold_67	201539	201552	13	4	no	NA	NA
10097	scaffold_67	213159	214399	1240	159	yes	300849	-
10098	scaffold_67	218456	219603	1147	103	yes	163522	-
10099	scaffold_67	231539	232943	1404	137	yes	405515	-
10100	scaffold_67	235537	235638	101	19	no	NA	NA
10101	scaffold_67	247311	249101	1790	167	yes	223817	-
10102	scaffold_67	251234	252134	900	100	yes	331236	-
10103	scaffold_67	254557	256368	1811	212	yes	331237	+
10104	scaffold_67	257510	258779	1269	164	yes	405523	+
10105	scaffold_67	266063	266739	676	84	no	NA	NA
10106	scaffold_67	269220	271471	2251	241	yes	405524	-
10107	scaffold_67	275296	276487	1191	97	yes	331246	-
10108	scaffold_67	279556	280610	1054	92	yes	331248	-
10109	scaffold_67	283077	284398	1321	171	yes	300863	-
10110	scaffold_67	285743	286927	1184	130	yes	405528	-
10111	scaffold_67	291506	292518	1012	123	yes	331253,331255	-,+
10112	scaffold_67	292738	293961	1223	162	yes	331253,331255	-,+
10113	scaffold_67	295045	295103	58	14	no	NA	NA
10114	scaffold_67	295189	295424	235	27	no	NA	NA
10115	scaffold_67	296773	297706	933	93	yes	430553	-
10116	scaffold_67	311575	311966	391	32	yes	397069	+
10117	scaffold_67	327964	328518	554	35	no	NA	NA
10118	scaffold_67	344385	345638	1253	115	yes	405539	+
10119	scaffold_67	352777	353960	1183	128	yes	380440	-
10120	scaffold_67	354956	355655	699	86	yes	405541	+
10121	scaffold_67	359419	360459	1040	129	yes	331271	+
10122	scaffold_67	364512	365925	1413	137	yes	430563	+
10123	scaffold_67	374629	375108	479	41	yes	300880	+
10124	scaffold_67	383471	385308	1837	141	yes	163991	-
10125	scaffold_90	5902	6607	705	94	yes	431558	+
10126	scaffold_90	37086	38233	1147	107	yes	191461	+
10127	scaffold_90	64289	64313	24	6	yes	333790	-
10128	scaffold_90	73652	74835	1183	164	yes	250037	-
10129	scaffold_90	76925	78281	1356	156	yes	404367	-
10130	scaffold_90	80711	81487	776	112	yes	333799	-
10131	scaffold_90	87975	89143	1168	155	yes	333801	+
10132	scaffold_90	91478	92691	1213	128	yes	333803	-
10133	scaffold_90	97979	99095	1116	84	yes	250043	-
10134	scaffold_90	102322	103702	1380	204	yes	333807	+
10135	scaffold_90	111636	112420	784	81	no	NA	NA
10136	scaffold_90	114728	115511	783	86	no	NA	NA
10137	scaffold_90	122471	123697	1226	94	yes	404378	-
10138	scaffold_90	124375	125389	1014	73	no	NA	NA
10139	scaffold_90	128424	130008	1584	145	no	NA	NA
10140	scaffold_90	133772	134236	464	47	no	NA	NA
10141	scaffold_90	134391	135563	1172	115	no	NA	NA
10142	scaffold_90	144316	145510	1194	98	no	NA	NA
10143	scaffold_90	153921	155216	1295	93	no	NA	NA
10144	scaffold_90	156349	157125	776	100	yes	333816	+
10145	scaffold_90	157258	157262	4	4	no	NA	NA
10146	scaffold_90	169418	170240	822	90	yes	382755	-
10147	scaffold_90	176232	177205	973	94	no	NA	NA
10148	scaffold_90	183906	184738	832	96	no	NA	NA
10149	scaffold_90	184945	186115	1170	147	no	NA	NA
10150	scaffold_90	215168	215236	68	12	no	NA	NA
10151	scaffold_90	215349	217124	1775	195	yes	224801	-
10152	scaffold_90	223186	223684	498	49	no	NA	NA
10153	scaffold_90	232436	232638	202	22	yes	191923	+
10154	scaffold_90	242045	242477	432	36	yes	398071	+
10155	scaffold_90	256484	257547	1063	97	yes	333848	-
10156	scaffold_123	21302	22831	1529	175	yes	432446	-
10157	scaffold_123	28109	29238	1129	86	no	NA	NA
10158	scaffold_123	70935	72209	1274	144	no	NA	NA
10159	scaffold_123	78460	79342	882	124	yes	398910	-
10160	scaffold_123	90030	91365	1335	176	yes	336138	+
10161	scaffold_123	94531	95025	494	63	yes	32206	+
10162	scaffold_123	95744	96258	514	23	no	NA	NA
10163	scaffold_123	97220	97909	689	56	no	NA	NA
10164	scaffold_123	104767	106018	1251	195	yes	398917	+
10165	scaffold_123	106123	106236	113	22	no	NA	NA
10166	scaffold_123	107783	108812	1029	125	yes	398918,401614	+,-
10167	scaffold_123	114492	115123	631	75	no	NA	NA
10168	scaffold_161	6794	7192	398	44	no	NA	NA
10169	scaffold_161	15739	15769	30	12	no	NA	NA
10170	scaffold_195	20185	20209	24	4	no	NA	NA
10171	scaffold_195	20447	20456	9	4	no	NA	NA
10172	scaffold_195	20597	20773	176	23	no	NA	NA
10173	scaffold_195	20980	20989	9	4	no	NA	NA
10174	scaffold_195	21130	21311	181	24	no	NA	NA
10175	scaffold_195	21569	21577	8	3	no	NA	NA
10176	scaffold_314	3525	3541	16	6	no	NA	NA
10177	scaffold_68	5181	5200	19	6	no	NA	NA
10178	scaffold_68	14526	15171	645	59	yes	430568	-
10179	scaffold_68	16558	17494	936	72	yes	331296	+
10180	scaffold_68	36154	37648	1494	146	yes	331318	-
10181	scaffold_68	41046	42190	1144	110	yes	236810	-
10182	scaffold_68	42818	43778	960	93	yes	331324	-
10183	scaffold_68	52441	53789	1348	152	yes	331331	+
10184	scaffold_68	65635	66900	1265	131	yes	223851	-
10185	scaffold_68	68949	69989	1040	109	yes	380460	-
10186	scaffold_68	70962	73941	2979	342	yes	402966,402967	+,-
10187	scaffold_68	95096	96268	1172	114	yes	164289	+
10188	scaffold_68	97996	98965	969	129	yes	331348	+
10189	scaffold_68	101919	103440	1521	135	yes	300905	+
10190	scaffold_68	103541	103611	70	8	no	NA	NA
10191	scaffold_68	108969	110135	1166	175	yes	223911	-
10192	scaffold_68	111198	112563	1365	147	yes	331358	+
10193	scaffold_68	121429	121992	563	58	yes	430587	+
10194	scaffold_68	132607	133767	1160	106	yes	331367	+
10195	scaffold_68	137410	138943	1533	202	yes	397105	-
10196	scaffold_68	143305	144340	1035	105	yes	236836	-
10197	scaffold_68	146403	147752	1349	163	yes	331374	-
10198	scaffold_68	148163	149237	1074	112	yes	331374,331375	-,+
10199	scaffold_68	151565	153036	1471	173	yes	331376,331378	-,+
10200	scaffold_68	153223	154292	1069	96	yes	331376,331378	-,+
10201	scaffold_68	158540	159343	803	71	yes	430594	-
10202	scaffold_68	163353	164348	995	132	yes	331383,397112	-,+
10203	scaffold_68	164781	166369	1588	147	yes	397112	+
10204	scaffold_68	169737	170374	637	86	yes	300922	-
10205	scaffold_68	171383	172230	847	75	yes	331390	+
10206	scaffold_68	178028	179220	1192	143	yes	164600	-
10207	scaffold_68	184024	185461	1437	152	yes	397116	-
10208	scaffold_68	189169	189996	827	124	yes	397117	-
10209	scaffold_68	193995	195313	1318	155	yes	331406	-
10210	scaffold_68	197725	198883	1158	114	yes	204522	+
10211	scaffold_68	201290	202090	800	98	no	NA	NA
10212	scaffold_68	214627	215168	541	58	yes	331419	+
10213	scaffold_68	219229	219807	578	66	yes	430609	+
10214	scaffold_68	227459	227950	491	50	yes	331426	+
10215	scaffold_68	232383	233322	939	120	no	NA	NA
10216	scaffold_68	240142	240900	758	63	yes	380497	+
10217	scaffold_68	247427	247438	11	6	no	NA	NA
10218	scaffold_68	250799	251109	310	20	yes	430615	+
10219	scaffold_68	294396	294924	528	62	yes	430620	-
10220	scaffold_68	296001	297441	1440	146	yes	430621	+
10221	scaffold_68	300628	300640	12	4	yes	403016	-
10222	scaffold_68	300843	301977	1134	126	yes	403016	-
10223	scaffold_68	333158	333194	36	10	yes	430628	-
10224	scaffold_68	339606	340601	995	154	yes	249260	-
10225	scaffold_68	346926	348077	1151	123	yes	331469	+
10226	scaffold_68	350858	351948	1090	112	yes	403029	+
10227	scaffold_68	355982	357407	1425	172	yes	331473	+
10228	scaffold_68	357511	357525	14	4	no	NA	NA
10229	scaffold_89	9962	10455	493	64	yes	186899	-
10230	scaffold_89	11689	11714	25	6	no	NA	NA
10231	scaffold_89	11991	12138	147	15	no	NA	NA
10232	scaffold_89	12259	12480	221	26	yes	333610	+
10233	scaffold_89	14003	14077	74	16	no	NA	NA
10234	scaffold_89	20880	20924	44	4	yes	186919	+
10235	scaffold_89	27552	27604	52	12	no	NA	NA
10236	scaffold_89	28123	28191	68	16	no	NA	NA
10237	scaffold_89	34557	34588	31	8	no	NA	NA
10238	scaffold_89	34908	34963	55	13	no	NA	NA
10239	scaffold_89	41891	42123	232	32	no	NA	NA
10240	scaffold_89	42345	42945	600	67	yes	415767	+
10241	scaffold_89	66772	66810	38	6	no	NA	NA
10242	scaffold_89	72390	72490	100	12	no	NA	NA
10243	scaffold_89	72674	73816	1142	152	no	NA	NA
10244	scaffold_89	74247	75101	854	76	no	NA	NA
10245	scaffold_89	87952	87956	4	4	no	NA	NA
10246	scaffold_89	101394	101812	418	54	no	NA	NA
10247	scaffold_89	103417	103862	445	47	no	NA	NA
10248	scaffold_89	114343	114402	59	3	no	NA	NA
10249	scaffold_89	120967	120988	21	4	no	NA	NA
10250	scaffold_89	121394	121445	51	10	no	NA	NA
10251	scaffold_89	121776	122227	451	34	no	NA	NA
10252	scaffold_89	166587	166596	9	6	no	NA	NA
10253	scaffold_89	166910	166929	19	8	no	NA	NA
10254	scaffold_89	169785	171017	1232	171	yes	415782	+
10255	scaffold_89	171114	171119	5	4	no	NA	NA
10256	scaffold_89	180076	181610	1534	185	yes	333645,415786	-,+
10257	scaffold_89	190895	191428	533	42	yes	431546	-
10258	scaffold_89	201433	202264	831	110	yes	333649	-
10259	scaffold_89	256016	256040	24	8	no	NA	NA
10260	scaffold_89	256516	256533	17	7	no	NA	NA
10261	scaffold_89	263127	263146	19	7	no	NA	NA
10262	scaffold_122	15607	16576	969	141	yes	303229	+
10263	scaffold_122	20538	20702	164	28	no	NA	NA
10264	scaffold_122	24888	24976	88	16	yes	238465	-
10265	scaffold_122	25322	25966	644	80	yes	238465	-
10266	scaffold_122	81928	81966	38	14	no	NA	NA
10267	scaffold_122	82976	83018	42	7	no	NA	NA
10268	scaffold_122	83085	84230	1145	132	no	NA	NA
10269	scaffold_122	85401	85905	504	37	yes	336068	+
10270	scaffold_122	96702	96973	271	20	yes	336072	-
10271	scaffold_122	99899	99909	10	4	yes	432441	-
10272	scaffold_122	101002	101988	986	110	no	NA	NA
10273	scaffold_122	103317	104564	1247	142	yes	250784	+
10274	scaffold_164	30947	32117	1170	163	yes	336858	-
10275	scaffold_69	8705	9696	991	119	yes	397150	+
10276	scaffold_69	15555	16592	1037	94	yes	397152	+
10277	scaffold_69	26514	26520	6	4	yes	331501	+
10278	scaffold_69	36557	36612	55	6	no	NA	NA
10279	scaffold_69	36695	37931	1236	178	yes	410806	-
10280	scaffold_69	64334	65320	986	126	no	NA	NA
10281	scaffold_69	77429	77859	430	30	yes	380569	+
10282	scaffold_69	87323	88565	1242	137	no	NA	NA
10283	scaffold_69	98274	99070	796	121	no	NA	NA
10284	scaffold_69	120243	120313	70	9	no	NA	NA
10285	scaffold_69	120396	121032	636	107	no	NA	NA
10286	scaffold_69	159103	159920	817	90	yes	300996	-
10287	scaffold_69	162482	162497	15	6	no	NA	NA
10288	scaffold_69	167064	168676	1612	189	yes	430666	-
10289	scaffold_69	169078	169803	725	87	no	NA	NA
10290	scaffold_69	201161	202410	1249	119	no	NA	NA
10291	scaffold_69	222714	223814	1100	127	yes	165325	+
10292	scaffold_69	247219	248066	847	89	yes	331565	-
10293	scaffold_69	249407	250744	1337	184	no	NA	NA
10294	scaffold_69	250880	250998	118	10	no	NA	NA
10295	scaffold_69	287911	288839	928	106	no	NA	NA
10296	scaffold_69	295775	297038	1263	148	yes	410877	+
10297	scaffold_69	297551	297722	171	7	no	NA	NA
10298	scaffold_69	315376	315993	617	68	yes	331588	-
10299	scaffold_69	316257	316388	131	8	yes	331588	-
10300	scaffold_69	321917	321932	15	6	no	NA	NA
10301	scaffold_69	322202	322997	795	84	yes	410882	-
10302	scaffold_69	323194	324525	1331	144	yes	410882,301038,397200	-,+,+
10303	scaffold_69	336853	338273	1420	186	yes	249316	-
10304	scaffold_69	338854	340161	1307	150	no	NA	NA
10305	scaffold_69	345673	346698	1025	148	yes	380672,410891	-,+
10306	scaffold_69	360287	360347	60	18	no	NA	NA
10307	scaffold_69	361432	361492	60	16	no	NA	NA
10308	scaffold_69	363696	363717	21	8	no	NA	NA
10309	scaffold_69	366113	366134	21	8	no	NA	NA
10310	scaffold_69	369093	369154	61	16	no	NA	NA
10311	scaffold_69	370003	370070	67	16	no	NA	NA
10312	scaffold_69	371037	371059	22	8	no	NA	NA
10313	scaffold_69	371998	372017	19	8	no	NA	NA
10314	scaffold_69	372984	373044	60	16	no	NA	NA
10315	scaffold_69	374594	374628	34	11	no	NA	NA
10316	scaffold_88	15057	15114	57	14	yes	382404	-
10317	scaffold_88	15194	15461	267	40	yes	382404	-
10318	scaffold_88	15735	15876	141	32	no	NA	NA
10319	scaffold_88	15940	15948	8	4	no	NA	NA
10320	scaffold_88	17582	17615	33	6	no	NA	NA
10321	scaffold_88	26565	27401	836	95	no	NA	NA
10322	scaffold_88	27537	27743	206	28	no	NA	NA
10323	scaffold_88	27890	28083	193	24	no	NA	NA
10324	scaffold_88	28601	28617	16	4	no	NA	NA
10325	scaffold_88	28908	28935	27	8	no	NA	NA
10326	scaffold_88	29166	29175	9	4	no	NA	NA
10327	scaffold_88	38928	38974	46	14	no	NA	NA
10328	scaffold_88	58349	58612	263	40	no	NA	NA
10329	scaffold_88	72885	72920	35	9	yes	431513	-
10330	scaffold_88	73548	74096	548	68	no	NA	NA
10331	scaffold_88	77089	77102	13	6	no	NA	NA
10332	scaffold_88	91310	91898	588	78	yes	382412	-
10333	scaffold_88	114418	114930	512	40	no	NA	NA
10334	scaffold_88	115035	115057	22	8	no	NA	NA
10335	scaffold_88	118299	118319	20	10	no	NA	NA
10336	scaffold_88	131068	131676	608	80	yes	403054	-
10337	scaffold_88	131844	131902	58	10	no	NA	NA
10338	scaffold_88	134659	134697	38	9	no	NA	NA
10339	scaffold_88	135414	135426	12	6	no	NA	NA
10340	scaffold_88	136360	137333	973	101	no	NA	NA
10341	scaffold_88	137673	138881	1208	130	yes	302063,403055	+,-
10342	scaffold_88	139449	140469	1020	113	yes	302063	+
10343	scaffold_88	145221	145228	7	4	yes	333585	-
10344	scaffold_88	149108	150124	1016	123	no	NA	NA
10345	scaffold_88	150549	151566	1017	113	no	NA	NA
10346	scaffold_88	156768	156786	18	5	no	NA	NA
10347	scaffold_88	168146	168192	46	10	no	NA	NA
10348	scaffold_88	170671	170814	143	30	no	NA	NA
10349	scaffold_88	172363	172383	20	6	no	NA	NA
10350	scaffold_88	172474	172520	46	12	no	NA	NA
10351	scaffold_88	173188	173671	483	60	no	NA	NA
10352	scaffold_88	185279	185380	101	13	no	NA	NA
10353	scaffold_88	197906	199585	1679	158	no	NA	NA
10354	scaffold_88	200025	200034	9	6	no	NA	NA
10355	scaffold_88	206056	206663	607	86	yes	403070	-
10356	scaffold_88	210296	210322	26	8	yes	403071	-
10357	scaffold_88	210927	210965	38	7	no	NA	NA
10358	scaffold_88	225498	225524	26	6	no	NA	NA
10359	scaffold_88	225925	225963	38	12	no	NA	NA
10360	scaffold_88	226170	226184	14	4	no	NA	NA
10361	scaffold_88	243131	243316	185	26	no	NA	NA
10362	scaffold_88	243455	243965	510	63	no	NA	NA
10363	scaffold_88	244570	244598	28	10	no	NA	NA
10364	scaffold_88	244739	244781	42	9	no	NA	NA
10365	scaffold_88	265913	265935	22	3	no	NA	NA
10366	scaffold_119	34910	35569	659	98	no	NA	NA
10367	scaffold_119	44464	46860	2396	246	yes	335984	-
10368	scaffold_119	47514	47533	19	8	no	NA	NA
10369	scaffold_119	52187	52648	461	41	yes	432394	+
10370	scaffold_119	76224	77730	1506	180	yes	335993	+
10371	scaffold_119	81343	81774	431	45	yes	408754	-
10372	scaffold_119	82163	82170	7	4	no	NA	NA
10373	scaffold_119	82440	82616	176	19	no	NA	NA
10374	scaffold_119	82726	83159	433	28	no	NA	NA
10375	scaffold_119	85822	87308	1486	168	no	NA	NA
10376	scaffold_119	89798	90296	498	34	yes	335996	+
10377	scaffold_119	93461	93544	83	16	no	NA	NA
10378	scaffold_119	94033	94088	55	16	no	NA	NA
10379	scaffold_119	94535	94584	49	12	no	NA	NA
10380	scaffold_119	95049	95114	65	16	no	NA	NA
10381	scaffold_119	101292	102650	1358	143	yes	408758	-
10382	scaffold_119	115652	115718	66	16	no	NA	NA
10383	scaffold_119	118942	119009	67	15	no	NA	NA
10384	scaffold_119	120039	120106	67	16	no	NA	NA
10385	scaffold_119	121530	121598	68	16	no	NA	NA
10386	scaffold_119	122809	122824	15	5	no	NA	NA
10387	scaffold_119	123964	124032	68	14	no	NA	NA
10388	scaffold_119	125184	125204	20	8	no	NA	NA
10389	scaffold_119	126229	126295	66	16	yes	408763	+
10390	scaffold_119	127117	127152	35	12	yes	303202	+
10391	scaffold_119	133059	133118	59	13	no	NA	NA
10392	scaffold_174	7822	8993	1171	164	yes	336961	-
10393	scaffold_174	10073	11170	1097	128	no	NA	NA
10394	scaffold_70	13295	13361	66	5	yes	301051	-
10395	scaffold_70	13457	13687	230	13	yes	301051	-
10396	scaffold_70	25680	26208	528	29	yes	223994	+
10397	scaffold_70	30366	31479	1113	116	yes	331617	-
10398	scaffold_70	31596	31823	227	20	yes	331617	-
10399	scaffold_70	34540	35529	989	136	yes	168312,331624	+,-
10400	scaffold_70	41088	42220	1132	105	yes	331628	-
10401	scaffold_70	43905	45166	1261	130	yes	331631	+
10402	scaffold_70	50913	51668	755	52	yes	331635	+
10403	scaffold_70	72093	72109	16	6	no	NA	NA
10404	scaffold_70	74444	75253	809	75	yes	430709	+
10405	scaffold_70	82685	83845	1160	99	yes	331644	+
10406	scaffold_70	87985	89042	1057	92	yes	301065	-
10407	scaffold_70	100943	102017	1074	122	yes	331656,414903	+,-
10408	scaffold_70	102201	103256	1055	108	yes	331656,414903,331658	+,-,+
10409	scaffold_70	107367	108504	1137	147	yes	331661	-
10410	scaffold_70	111173	112031	858	96	yes	249335	-
10411	scaffold_70	119555	120761	1206	136	yes	224033	+
10412	scaffold_70	129155	129958	803	67	yes	331670	+
10413	scaffold_70	141500	141808	308	20	no	NA	NA
10414	scaffold_70	154356	155224	868	114	no	NA	NA
10415	scaffold_70	155406	155456	50	7	yes	380990	+
10416	scaffold_70	174230	175239	1009	152	no	NA	NA
10417	scaffold_70	187291	188040	749	90	yes	236982	-
10418	scaffold_70	201528	201743	215	25	yes	168728	+
10419	scaffold_70	201883	201989	106	6	no	NA	NA
10420	scaffold_70	217993	218007	14	4	no	NA	NA
10421	scaffold_70	249588	251121	1533	134	yes	331696,414924	+,-
10422	scaffold_70	251318	252404	1086	116	yes	331696	+
10423	scaffold_70	255303	256315	1012	99	yes	414926	-
10424	scaffold_70	258123	259479	1356	114	yes	414927	+
10425	scaffold_70	267994	269119	1125	107	yes	224021	-
10426	scaffold_70	273002	274103	1101	108	yes	168801	+
10427	scaffold_70	283548	284631	1083	96	yes	414930	+
10428	scaffold_70	288797	289816	1019	113	no	NA	NA
10429	scaffold_70	296077	297016	939	95	yes	331713	-
10430	scaffold_70	300442	301555	1113	164	yes	397254	+
10431	scaffold_70	302852	303862	1010	147	yes	301100	+
10432	scaffold_70	303970	304011	41	3	no	NA	NA
10433	scaffold_70	308810	310864	2054	255	yes	331718	-
10434	scaffold_70	317600	317742	142	10	no	NA	NA
10435	scaffold_70	317938	319299	1361	155	yes	397257	-
10436	scaffold_70	328280	329559	1279	126	yes	430743	-
10437	scaffold_70	335940	336727	787	100	yes	237003	-
10438	scaffold_70	337023	338385	1362	166	yes	237003,224023	-,+
10439	scaffold_70	347168	347172	4	4	no	NA	NA
10440	scaffold_70	347290	347895	605	52	no	NA	NA
10441	scaffold_70	360291	360966	675	41	yes	331732	+
10442	scaffold_87	57273	58495	1222	120	yes	302010	+
10443	scaffold_87	58609	58626	17	4	no	NA	NA
10444	scaffold_87	62920	63765	845	93	yes	333496	+
10445	scaffold_87	67346	68029	683	76	yes	414185	+
10446	scaffold_87	88430	89755	1325	146	no	NA	NA
10447	scaffold_87	89955	89972	17	8	no	NA	NA
10448	scaffold_87	107176	107259	83	14	yes	302017	+
10449	scaffold_87	146556	146574	18	3	yes	333517	-
10450	scaffold_87	157885	158804	919	119	yes	397978	-
10451	scaffold_87	183452	183848	396	44	yes	186433	-
10452	scaffold_87	194070	195412	1342	166	yes	397982	+
10453	scaffold_87	199106	200207	1101	135	yes	333526	+
10454	scaffold_87	200923	202198	1275	130	yes	333526	+
10455	scaffold_87	204344	204919	575	63	yes	333528	+
10456	scaffold_87	215678	217424	1746	159	yes	333530	-
10457	scaffold_87	218027	218590	563	82	yes	333531	+
10458	scaffold_87	224196	224205	9	4	no	NA	NA
10459	scaffold_87	224798	225681	883	97	yes	333535	-
10460	scaffold_87	227903	228524	621	69	yes	397989	-
10461	scaffold_87	231249	231918	669	81	yes	397990	-
10462	scaffold_87	233311	234137	826	85	yes	186498	-
10463	scaffold_87	235538	237685	2147	231	yes	431503	+
10464	scaffold_87	238759	240159	1400	114	yes	414226	+
10465	scaffold_87	254346	254362	16	6	no	NA	NA
10466	scaffold_87	260124	260147	23	7	no	NA	NA
10467	scaffold_87	270012	270030	18	5	no	NA	NA
10468	scaffold_227	941	1941	1000	73	no	NA	NA
10469	scaffold_285	9886	9903	17	7	no	NA	NA
10470	scaffold_285	10381	10404	23	7	no	NA	NA
10471	scaffold_71	2594	3363	769	68	no	NA	NA
10472	scaffold_71	7347	7371	24	8	no	NA	NA
10473	scaffold_71	12792	12816	24	9	no	NA	NA
10474	scaffold_71	53698	54292	594	53	yes	418165	-
10475	scaffold_71	60013	60023	10	6	no	NA	NA
10476	scaffold_71	70939	72194	1255	80	no	NA	NA
10477	scaffold_71	76201	76662	461	34	yes	386126	+
10478	scaffold_71	80598	81586	988	55	yes	397271	-
10479	scaffold_71	87512	87980	468	55	yes	418171	-
10480	scaffold_71	106030	106752	722	63	yes	169119	+
10481	scaffold_71	111310	111955	645	79	no	NA	NA
10482	scaffold_71	116073	117218	1145	132	yes	397278,430765	+,+
10483	scaffold_71	155081	155088	7	4	yes	430768	-
10484	scaffold_71	155815	155825	10	5	no	NA	NA
10485	scaffold_71	161879	162803	924	60	yes	430769	-
10486	scaffold_71	169189	169913	724	59	yes	331769	+
10487	scaffold_71	173269	174446	1177	147	yes	169220,381054	+,+
10488	scaffold_71	199241	200191	950	114	yes	331782	-
10489	scaffold_71	202310	203015	705	71	yes	249381,331784	-,+
10490	scaffold_71	203414	204392	978	121	yes	249381,331784	-,+
10491	scaffold_71	206461	207280	819	95	yes	331786,397294	+,-
10492	scaffold_71	207480	208723	1243	141	yes	331786,397294,169315	+,-,+
10493	scaffold_71	209130	210062	932	121	yes	169315	+
10494	scaffold_71	210737	212071	1334	159	yes	331789	+
10495	scaffold_71	220583	221733	1150	112	yes	301147	+
10496	scaffold_71	223940	225112	1172	115	no	NA	NA
10497	scaffold_71	237217	237226	9	4	yes	224059	-
10498	scaffold_71	237333	237594	261	25	yes	224059	-
10499	scaffold_71	245296	245311	15	3	yes	169412	-
10500	scaffold_71	245474	246582	1108	81	yes	169412	-
10501	scaffold_71	254103	254195	92	6	yes	397304	-
10502	scaffold_71	254321	254393	72	18	yes	397304	-
10503	scaffold_71	265212	266122	910	92	yes	331808	-
10504	scaffold_71	268952	270387	1435	161	yes	301158,397311	-,+
10505	scaffold_71	271287	272643	1356	176	no	NA	NA
10506	scaffold_71	277520	278606	1086	135	yes	331816	+
10507	scaffold_71	281035	282240	1205	131	yes	331819	+
10508	scaffold_71	294699	295850	1151	132	yes	331822	-
10509	scaffold_71	296111	297415	1304	130	yes	331822	-
10510	scaffold_71	299306	299356	50	3	no	NA	NA
10511	scaffold_71	299601	300050	449	47	yes	331827	-
10512	scaffold_71	303709	304454	745	75	yes	301168	+
10513	scaffold_71	308937	310047	1110	108	yes	331832	-
10514	scaffold_71	312212	314005	1793	147	yes	397322	-
10515	scaffold_71	317928	319065	1137	123	yes	430798	-
10516	scaffold_71	320942	322554	1612	185	yes	331837	-
10517	scaffold_71	328090	328106	16	6	no	NA	NA
10518	scaffold_71	331828	333125	1297	140	yes	331843	+
10519	scaffold_71	347077	348341	1264	154	yes	331847	+
10520	scaffold_71	352174	352187	13	4	no	NA	NA
10521	scaffold_71	355630	356384	754	80	yes	237058	-
10522	scaffold_71	364614	365680	1066	99	yes	301180	+
10523	scaffold_86	5690	6871	1181	156	yes	419211	+
10524	scaffold_86	30169	30859	690	36	yes	224664	+
10525	scaffold_86	37420	38971	1551	188	yes	397917	-
10526	scaffold_86	58554	59692	1138	90	yes	397920	-
10527	scaffold_86	74768	75937	1169	138	yes	333386,333389	-,+
10528	scaffold_86	76337	77429	1092	150	yes	333389	+
10529	scaffold_86	80235	80896	661	78	yes	419225	+
10530	scaffold_86	85466	86454	988	85	yes	333392	-
10531	scaffold_86	91226	92539	1313	127	yes	333394	-
10532	scaffold_86	102591	104004	1413	108	yes	419228,419229	-,-
10533	scaffold_86	105657	106798	1141	155	yes	185704	-
10534	scaffold_86	107414	108670	1256	118	yes	431438	+
10535	scaffold_86	115541	116783	1242	144	yes	301970	+
10536	scaffold_86	134687	134972	285	28	yes	366471	+
10537	scaffold_86	135217	135289	72	16	yes	366471	+
10538	scaffold_86	140866	141745	879	114	no	NA	NA
10539	scaffold_86	159123	160901	1778	187	no	NA	NA
10540	scaffold_86	162326	162798	472	19	no	NA	NA
10541	scaffold_86	164162	165181	1019	117	yes	431447	+
10542	scaffold_86	190892	191795	903	96	yes	249946	-
10543	scaffold_86	195825	195953	128	38	no	NA	NA
10544	scaffold_86	203566	204407	841	76	yes	333457	+
10545	scaffold_86	213605	214395	790	77	no	NA	NA
10546	scaffold_86	217252	218327	1075	112	yes	301988	+
10547	scaffold_86	222190	223333	1143	92	yes	301989	-
10548	scaffold_86	227420	228045	625	67	no	NA	NA
10549	scaffold_86	232189	233703	1514	162	yes	431461	+
10550	scaffold_86	238995	240100	1105	147	yes	333472,333474	-,+
10551	scaffold_86	240611	243594	2983	291	yes	333472,333474,431464	-,+,-
10552	scaffold_86	245480	245506	26	7	no	NA	NA
10553	scaffold_86	262503	263550	1047	129	yes	249954,333478	+,-
10554	scaffold_86	263746	264520	774	103	yes	249954,333478	+,-
10555	scaffold_86	266932	268093	1161	170	yes	186228	-
10556	scaffold_86	271574	271613	39	12	no	NA	NA
10557	scaffold_86	274750	274762	12	5	no	NA	NA
10558	scaffold_120	5961	5979	18	8	no	NA	NA
10559	scaffold_120	6455	6474	19	6	no	NA	NA
10560	scaffold_120	8402	8437	35	12	no	NA	NA
10561	scaffold_120	29082	29101	19	6	no	NA	NA
10562	scaffold_120	72682	72949	267	33	no	NA	NA
10563	scaffold_120	129283	129497	214	32	no	NA	NA
10564	scaffold_120	129598	129691	93	16	no	NA	NA
10565	scaffold_120	129753	129774	21	7	no	NA	NA
10566	scaffold_284	7477	7643	166	10	yes	402005	-
10567	scaffold_85	11739	13315	1576	125	yes	301900	-
10568	scaffold_85	17010	18547	1537	130	yes	224643	-
10569	scaffold_85	24542	24806	264	14	yes	431381	+
10570	scaffold_85	31668	31886	218	26	yes	333285	-
10571	scaffold_85	32047	32728	681	74	yes	333285	-
10572	scaffold_85	56710	56721	11	4	yes	237530	-
10573	scaffold_85	56888	57504	616	46	yes	237530	-
10574	scaffold_85	58118	59514	1396	175	no	NA	NA
10575	scaffold_85	59697	60462	765	80	no	NA	NA
10576	scaffold_85	72559	72573	14	4	no	NA	NA
10577	scaffold_85	73459	73629	170	19	no	NA	NA
10578	scaffold_85	73810	74219	409	50	yes	431388	-
10579	scaffold_85	79822	80660	838	87	no	NA	NA
10580	scaffold_85	80869	80906	37	4	no	NA	NA
10581	scaffold_85	90635	90890	255	23	no	NA	NA
10582	scaffold_85	90994	91012	18	6	no	NA	NA
10583	scaffold_85	93813	94459	646	64	yes	382293	+
10584	scaffold_85	99967	100767	800	102	no	NA	NA
10585	scaffold_85	114171	114186	15	4	yes	301915	+
10586	scaffold_85	114529	114940	411	40	yes	301915	+
10587	scaffold_85	127257	127294	37	6	no	NA	NA
10588	scaffold_85	138880	139509	629	44	yes	397894	-
10589	scaffold_85	142180	142847	667	103	no	NA	NA
10590	scaffold_85	144011	145402	1391	175	yes	185314	+
10591	scaffold_85	149794	149825	31	8	no	NA	NA
10592	scaffold_85	170555	171136	581	56	yes	333321	+
10593	scaffold_85	174940	175923	983	125	yes	397899	+
10594	scaffold_85	195454	196245	791	64	no	NA	NA
10595	scaffold_85	203870	204839	969	97	yes	333333	-
10596	scaffold_85	206258	207622	1364	163	no	NA	NA
10597	scaffold_85	207753	207830	77	8	no	NA	NA
10598	scaffold_85	226928	226937	9	4	yes	397907	+
10599	scaffold_85	227247	228492	1245	152	no	NA	NA
10600	scaffold_85	241127	241772	645	55	yes	301944	+
10601	scaffold_85	244474	244967	493	18	no	NA	NA
10602	scaffold_85	250321	252098	1777	202	yes	418137	+
10603	scaffold_85	255689	256561	872	110	yes	431414	-
10604	scaffold_85	271129	271407	278	33	no	NA	NA
10605	scaffold_85	271501	271687	186	16	no	NA	NA
10606	scaffold_85	273778	274767	989	89	no	NA	NA
10607	scaffold_85	275318	276499	1181	179	yes	333357	-
10608	scaffold_116	8770	10127	1357	116	yes	402540	-
10609	scaffold_116	11718	13181	1463	185	yes	398779	+
10610	scaffold_116	25907	26704	797	89	yes	335842	-
10611	scaffold_116	27579	29127	1548	167	yes	335844	+
10612	scaffold_116	41025	41172	147	10	yes	225526	+
10613	scaffold_116	41359	42571	1212	154	yes	225526	+
10614	scaffold_116	42865	43948	1083	118	yes	250655	+
10615	scaffold_116	46121	47058	937	91	yes	335849	-
10616	scaffold_116	47566	48842	1276	141	yes	335849,402548	-,+
10617	scaffold_116	55765	56758	993	114	yes	335856	+
10618	scaffold_116	58330	59253	923	116	yes	335859	+
10619	scaffold_116	61438	62816	1378	143	yes	398790	-
10620	scaffold_116	74817	75930	1113	118	yes	386297	-
10621	scaffold_116	77561	77970	409	40	yes	250675	+
10622	scaffold_116	78100	79258	1158	102	no	NA	NA
10623	scaffold_116	81206	82913	1707	161	yes	368389	+
10624	scaffold_116	93877	95023	1146	141	yes	335886	+
10625	scaffold_116	98198	99809	1611	187	yes	402560	-
10626	scaffold_116	101382	101959	577	85	yes	335891	+
10627	scaffold_116	102151	102966	815	104	yes	335891	+
10628	scaffold_116	109220	110115	895	107	yes	335896	-
10629	scaffold_116	117071	118578	1507	152	yes	398803	+
10630	scaffold_116	121092	121125	33	3	no	NA	NA
10631	scaffold_116	134950	135935	985	84	no	NA	NA
10632	scaffold_116	141695	141713	18	6	no	NA	NA
10633	scaffold_344	3081	4167	1086	126	yes	303977	+
10634	scaffold_72	19872	19956	84	28	no	NA	NA
10635	scaffold_72	42084	43241	1157	129	yes	406374	-
10636	scaffold_72	55484	57015	1531	154	no	NA	NA
10637	scaffold_72	60319	61498	1179	119	yes	301184	+
10638	scaffold_72	66838	67004	166	17	yes	331863	+
10639	scaffold_72	67604	67869	265	20	yes	331863	+
10640	scaffold_72	81409	82688	1279	159	yes	397333	+
10641	scaffold_72	105580	105812	232	16	yes	381097	+
10642	scaffold_72	114697	115953	1256	154	no	NA	NA
10643	scaffold_72	116047	116102	55	16	no	NA	NA
10644	scaffold_72	119388	120694	1306	154	yes	170043	+
10645	scaffold_72	124137	125309	1172	81	yes	397340	+
10646	scaffold_72	128289	129516	1227	112	yes	331891	-
10647	scaffold_72	130936	132144	1208	156	yes	331892	+
10648	scaffold_72	135409	136595	1186	136	yes	430822	-
10649	scaffold_72	136869	139401	2532	220	yes	430822,430823	-,-
10650	scaffold_72	151032	151805	773	57	yes	430826	-
10651	scaffold_72	158274	159265	991	105	yes	331902	-
10652	scaffold_72	160528	162139	1611	182	yes	406399	+
10653	scaffold_72	180583	181716	1133	114	yes	381109	-
10654	scaffold_72	200805	200852	47	4	no	NA	NA
10655	scaffold_72	200931	202492	1561	180	yes	406408	-
10656	scaffold_72	204996	205994	998	91	yes	331915	-
10657	scaffold_72	206967	207870	903	89	yes	406411,406412	+,+
10658	scaffold_72	215346	215592	246	37	no	NA	NA
10659	scaffold_72	231212	231219	7	3	yes	397361	+
10660	scaffold_72	240438	241192	754	65	no	NA	NA
10661	scaffold_72	241370	241390	20	6	no	NA	NA
10662	scaffold_72	241513	241533	20	6	no	NA	NA
10663	scaffold_72	245173	245182	9	4	no	NA	NA
10664	scaffold_72	258870	258921	51	16	no	NA	NA
10665	scaffold_72	260981	261032	51	16	no	NA	NA
10666	scaffold_72	261722	261752	30	10	no	NA	NA
10667	scaffold_72	263038	263096	58	18	no	NA	NA
10668	scaffold_72	264029	264062	33	10	no	NA	NA
10669	scaffold_72	276640	276691	51	16	no	NA	NA
10670	scaffold_72	332978	333413	435	46	yes	331942	-
10671	scaffold_72	336527	337974	1447	116	yes	331943	-
10672	scaffold_72	339936	340909	973	128	yes	224114	+
10673	scaffold_72	350239	351456	1217	105	no	NA	NA
10674	scaffold_72	354949	354959	10	2	no	NA	NA
10675	scaffold_84	7675	8564	889	111	no	NA	NA
10676	scaffold_84	9097	9909	812	90	no	NA	NA
10677	scaffold_84	32862	33201	339	33	yes	397861	-
10678	scaffold_84	33379	33456	77	22	yes	397861	-
10679	scaffold_84	33538	33607	69	12	yes	397861	-
10680	scaffold_84	34800	34838	38	9	no	NA	NA
10681	scaffold_84	35534	35539	5	4	no	NA	NA
10682	scaffold_84	36192	37448	1256	174	no	NA	NA
10683	scaffold_84	54547	54556	9	4	yes	431356	-
10684	scaffold_84	55568	55591	23	6	no	NA	NA
10685	scaffold_84	85871	86055	184	20	no	NA	NA
10686	scaffold_84	96766	96811	45	12	no	NA	NA
10687	scaffold_84	107300	107577	277	43	no	NA	NA
10688	scaffold_84	136270	137393	1123	135	no	NA	NA
10689	scaffold_84	137935	138009	74	12	no	NA	NA
10690	scaffold_84	138576	138636	60	10	no	NA	NA
10691	scaffold_84	139821	140612	791	86	no	NA	NA
10692	scaffold_84	141218	142296	1078	90	yes	333225	+
10693	scaffold_84	151995	152008	13	4	no	NA	NA
10694	scaffold_84	152193	152414	221	17	no	NA	NA
10695	scaffold_84	152883	152957	74	9	yes	382250	+
10696	scaffold_84	153284	153798	514	52	yes	382250	+
10697	scaffold_84	165107	165278	171	26	no	NA	NA
10698	scaffold_84	168691	169915	1224	164	no	NA	NA
10699	scaffold_84	176310	176873	563	84	no	NA	NA
10700	scaffold_84	249395	250432	1037	112	no	NA	NA
10701	scaffold_84	257285	258327	1042	69	yes	431376	-
10702	scaffold_114	20062	21351	1289	127	yes	366564	-
10703	scaffold_114	24076	24589	513	55	yes	335660	+
10704	scaffold_114	40529	41477	948	97	yes	406726	-
10705	scaffold_114	43791	44621	830	107	yes	432281	+
10706	scaffold_114	49383	50259	876	39	yes	432282	-
10707	scaffold_114	67761	68635	874	46	no	NA	NA
10708	scaffold_114	77478	78517	1039	114	yes	335676	+
10709	scaffold_114	79842	81311	1469	207	yes	225457	+
10710	scaffold_114	88380	89378	998	154	yes	335681,398740	-,+
10711	scaffold_114	89553	90014	461	62	yes	335681,398740	-,+
10712	scaffold_114	104920	105764	844	103	yes	398743	-
10713	scaffold_114	129444	130114	670	93	no	NA	NA
10714	scaffold_114	133431	133439	8	4	yes	250600	-
10715	scaffold_114	137369	137583	214	32	no	NA	NA
10716	scaffold_114	137684	137731	47	13	no	NA	NA
10717	scaffold_114	137839	137861	22	8	no	NA	NA
10718	scaffold_114	141307	141329	22	8	no	NA	NA
10719	scaffold_114	141391	141477	86	15	no	NA	NA
10720	scaffold_114	141585	141798	213	31	no	NA	NA
10721	scaffold_73	43237	43245	8	4	no	NA	NA
10722	scaffold_73	43699	44738	1039	99	yes	397378	-
10723	scaffold_73	57365	58623	1258	184	yes	430864	-
10724	scaffold_73	80050	81066	1016	122	no	NA	NA
10725	scaffold_73	90975	91472	497	52	yes	397381	+
10726	scaffold_73	96752	96941	189	12	yes	407468	-
10727	scaffold_73	97152	97209	57	8	yes	407468	-
10728	scaffold_73	101152	102161	1009	120	yes	331981	-
10729	scaffold_73	113662	115192	1530	182	yes	397386	-
10730	scaffold_73	116229	116831	602	76	no	NA	NA
10731	scaffold_73	117082	117798	716	91	yes	430872	-
10732	scaffold_73	126745	126753	8	4	no	NA	NA
10733	scaffold_73	151957	153393	1436	163	yes	397390	-
10734	scaffold_73	154183	155149	966	116	yes	331999	+
10735	scaffold_73	187562	188445	883	126	yes	249479,407485	-,+
10736	scaffold_73	251905	253026	1121	133	yes	224190	+
10737	scaffold_73	262698	263888	1190	166	yes	332032,332034	-,+
10738	scaffold_73	264123	265409	1286	146	yes	332032,332034	-,+
10739	scaffold_73	274723	276271	1548	173	yes	332041	-
10740	scaffold_73	278365	279177	812	101	yes	397414	-
10741	scaffold_73	310026	311024	998	105	yes	171194	-
10742	scaffold_73	321513	321532	19	7	no	NA	NA
10743	scaffold_73	322010	322028	18	8	no	NA	NA
10744	scaffold_73	326040	326079	39	12	no	NA	NA
10745	scaffold_73	341094	342121	1027	104	yes	332067	+
10746	scaffold_83	5002	5024	22	8	no	NA	NA
10747	scaffold_83	5131	5178	47	13	no	NA	NA
10748	scaffold_83	5279	5493	214	31	no	NA	NA
10749	scaffold_83	5764	5778	14	4	no	NA	NA
10750	scaffold_83	8996	9079	83	26	no	NA	NA
10751	scaffold_83	28191	28220	29	10	yes	401771	+
10752	scaffold_83	28357	29565	1208	148	no	NA	NA
10753	scaffold_83	41339	42059	720	72	yes	333109	+
10754	scaffold_83	81664	81700	36	10	no	NA	NA
10755	scaffold_83	83717	83759	42	16	no	NA	NA
10756	scaffold_83	102701	102799	98	16	yes	382184	+
10757	scaffold_83	103009	103175	166	19	yes	382184	+
10758	scaffold_83	103428	103440	12	6	yes	382184	+
10759	scaffold_83	103546	103943	397	40	yes	382184	+
10760	scaffold_83	104121	104158	37	8	no	NA	NA
10761	scaffold_83	106743	106753	10	3	no	NA	NA
10762	scaffold_83	107341	107604	263	28	no	NA	NA
10763	scaffold_83	107813	107831	18	6	no	NA	NA
10764	scaffold_83	110386	110398	12	4	yes	397846	-
10765	scaffold_83	110566	110732	166	37	yes	397846	-
10766	scaffold_83	110862	110900	38	8	yes	397846	-
10767	scaffold_83	111069	111092	23	5	yes	397846	-
10768	scaffold_83	113692	113735	43	8	no	NA	NA
10769	scaffold_83	113907	114112	205	30	no	NA	NA
10770	scaffold_83	114231	114251	20	8	no	NA	NA
10771	scaffold_83	121948	123522	1574	196	no	NA	NA
10772	scaffold_83	127551	127734	183	24	yes	401794	-
10773	scaffold_83	132310	132523	213	18	no	NA	NA
10774	scaffold_83	132666	132706	40	8	no	NA	NA
10775	scaffold_83	144778	144952	174	16	yes	401799	-
10776	scaffold_83	149333	149381	48	10	no	NA	NA
10777	scaffold_83	149766	149841	75	9	yes	401800	-
10778	scaffold_83	149972	150246	274	34	yes	401800	-
10779	scaffold_83	150396	150678	282	36	yes	401800	-
10780	scaffold_83	157285	157561	276	29	no	NA	NA
10781	scaffold_83	157711	157728	17	4	no	NA	NA
10782	scaffold_83	157850	157883	33	14	no	NA	NA
10783	scaffold_83	162245	162314	69	22	no	NA	NA
10784	scaffold_83	162432	162441	9	4	no	NA	NA
10785	scaffold_83	162586	162614	28	10	yes	401803	-
10786	scaffold_83	162945	162995	50	12	yes	401803	-
10787	scaffold_83	163309	163351	42	14	yes	401803	-
10788	scaffold_83	163706	163755	49	8	no	NA	NA
10789	scaffold_83	164067	164093	26	8	no	NA	NA
10790	scaffold_83	171852	171871	19	8	no	NA	NA
10791	scaffold_83	172350	172379	29	6	yes	431344	+
10792	scaffold_83	172560	172576	16	6	yes	431344	+
10793	scaffold_83	176551	176558	7	4	no	NA	NA
10794	scaffold_83	177048	177067	19	7	no	NA	NA
10795	scaffold_83	196748	196933	185	30	no	NA	NA
10796	scaffold_83	203147	203367	220	15	no	NA	NA
10797	scaffold_83	203584	203592	8	4	no	NA	NA
10798	scaffold_83	203794	203929	135	16	no	NA	NA
10799	scaffold_83	206475	206683	208	36	no	NA	NA
10800	scaffold_83	206777	206850	73	15	no	NA	NA
10801	scaffold_83	206989	207005	16	6	yes	431346	-
10802	scaffold_83	207313	207377	64	3	yes	431346	-
10803	scaffold_83	207515	207869	354	28	yes	431346	-
10804	scaffold_83	208237	208927	690	66	no	NA	NA
10805	scaffold_83	209150	210260	1110	133	yes	333160	+
10806	scaffold_83	210428	210462	34	12	yes	333160	+
10807	scaffold_83	210706	211024	318	24	yes	431348	+
10808	scaffold_83	211218	212240	1022	79	yes	431348	+
10809	scaffold_83	223310	223328	18	6	yes	431351	+
10810	scaffold_83	223510	223523	13	6	yes	431351	+
10811	scaffold_83	224106	224115	9	4	no	NA	NA
10812	scaffold_83	224300	224320	20	8	no	NA	NA
10813	scaffold_83	237916	237943	27	8	no	NA	NA
10814	scaffold_83	238288	238433	145	12	no	NA	NA
10815	scaffold_83	240955	241534	579	70	no	NA	NA
10816	scaffold_83	241615	243628	2013	167	yes	182511	-
10817	scaffold_83	243798	243926	128	11	no	NA	NA
10818	scaffold_83	245087	245171	84	10	no	NA	NA
10819	scaffold_83	251774	251783	9	4	no	NA	NA
10820	scaffold_83	263769	263775	6	3	no	NA	NA
10821	scaffold_83	264755	264815	60	10	no	NA	NA
10822	scaffold_83	268115	268122	7	4	yes	382228	-
10823	scaffold_83	268466	268584	118	22	yes	382228	-
10824	scaffold_83	269419	269426	7	4	no	NA	NA
10825	scaffold_83	269641	269699	58	14	no	NA	NA
10826	scaffold_83	270599	270666	67	15	no	NA	NA
10827	scaffold_83	272924	273000	76	17	no	NA	NA
10828	scaffold_83	276161	276212	51	9	yes	301870	+
10829	scaffold_83	276984	277051	67	15	no	NA	NA
10830	scaffold_83	280487	280856	369	53	no	NA	NA
10831	scaffold_83	292202	292451	249	18	no	NA	NA
10832	scaffold_83	292540	292828	288	16	no	NA	NA
10833	scaffold_83	292950	293110	160	13	no	NA	NA
10834	scaffold_83	293221	293746	525	37	no	NA	NA
10835	scaffold_83	293882	294058	176	8	no	NA	NA
10836	scaffold_109	15110	15140	30	3	yes	335340	+
10837	scaffold_109	16454	16620	166	13	no	NA	NA
10838	scaffold_109	16788	16816	28	6	no	NA	NA
10839	scaffold_109	16923	17397	474	30	no	NA	NA
10840	scaffold_109	19464	20469	1005	109	yes	225339	+
10841	scaffold_109	87502	88355	853	128	no	NA	NA
10842	scaffold_109	89407	89417	10	5	no	NA	NA
10843	scaffold_109	123135	123514	379	40	yes	335358	-
10844	scaffold_109	123645	123732	87	14	no	NA	NA
10845	scaffold_109	145502	146740	1238	132	yes	335362	+
10846	scaffold_109	150605	151880	1275	126	yes	302932	+
10847	scaffold_109	152091	152555	464	55	yes	302932	+
10848	scaffold_109	152643	152732	89	14	yes	302932	+
10849	scaffold_109	152807	152839	32	8	no	NA	NA
10850	scaffold_109	165658	165725	67	16	no	NA	NA
10851	scaffold_109	170039	170074	35	12	yes	302937	+
10852	scaffold_286	5532	5551	19	6	no	NA	NA
10853	scaffold_286	8844	8863	19	6	no	NA	NA
10854	scaffold_343	7215	7237	22	8	no	NA	NA
10855	scaffold_343	7345	7393	48	13	no	NA	NA
10856	scaffold_343	7493	7706	213	29	no	NA	NA
10857	scaffold_82	19728	20375	647	44	yes	333046	-
10858	scaffold_82	25715	25799	84	14	no	NA	NA
10859	scaffold_82	26203	26258	55	16	no	NA	NA
10860	scaffold_82	57540	57551	11	4	yes	401231	-
10861	scaffold_82	64939	64943	4	4	no	NA	NA
10862	scaffold_82	65110	65376	266	28	no	NA	NA
10863	scaffold_82	65605	65696	91	22	no	NA	NA
10864	scaffold_82	65797	65826	29	7	no	NA	NA
10865	scaffold_82	66069	66094	25	6	no	NA	NA
10866	scaffold_82	90369	90375	6	4	no	NA	NA
10867	scaffold_82	90483	90538	55	14	no	NA	NA
10868	scaffold_82	90985	91166	181	17	no	NA	NA
10869	scaffold_82	91690	91697	7	4	no	NA	NA
10870	scaffold_82	92373	92779	406	25	no	NA	NA
10871	scaffold_82	93069	93846	777	87	no	NA	NA
10872	scaffold_82	93915	93972	57	12	no	NA	NA
10873	scaffold_82	109534	109655	121	23	no	NA	NA
10874	scaffold_82	109754	109800	46	14	no	NA	NA
10875	scaffold_82	109975	110051	76	16	no	NA	NA
10876	scaffold_82	110154	110467	313	52	no	NA	NA
10877	scaffold_82	126434	126586	152	10	yes	382112	-
10878	scaffold_82	134723	134755	32	10	yes	382113	-
10879	scaffold_82	143578	143948	370	45	yes	301813	-
10880	scaffold_82	151293	151313	20	8	yes	382115	-
10881	scaffold_82	154268	155379	1111	88	no	NA	NA
10882	scaffold_82	162834	163805	971	88	yes	397827	-
10883	scaffold_82	172177	172448	271	16	yes	382122	-
10884	scaffold_82	172655	172691	36	8	yes	382122	-
10885	scaffold_82	180491	181727	1236	100	yes	397828	-
10886	scaffold_82	234335	236036	1701	205	yes	401258	+
10887	scaffold_82	240169	241280	1111	124	no	NA	NA
10888	scaffold_82	247390	247438	48	6	yes	431320	-
10889	scaffold_82	247529	247654	125	13	yes	431320	-
10890	scaffold_82	261786	261885	99	14	no	NA	NA
10891	scaffold_82	261975	262837	862	65	yes	333076	-
10892	scaffold_82	267821	268465	644	76	yes	397834	-
10893	scaffold_82	268950	270957	2007	225	yes	397834	-
10894	scaffold_82	271409	272163	754	79	yes	301827	-
10895	scaffold_82	285917	285968	51	6	no	NA	NA
10896	scaffold_82	286049	287069	1020	131	yes	397838	-
10897	scaffold_82	292608	292913	305	52	yes	333079	+
10898	scaffold_82	296669	297526	857	78	no	NA	NA
10899	scaffold_82	297738	297755	17	5	no	NA	NA
10900	scaffold_117	14391	14893	502	31	yes	335910	+
10901	scaffold_117	35791	36744	953	87	yes	409609	+
10902	scaffold_117	50372	50385	13	6	yes	335916	+
10903	scaffold_117	57520	57556	36	7	no	NA	NA
10904	scaffold_117	57855	58834	979	87	yes	409614	-
10905	scaffold_117	68887	69985	1098	137	yes	335927	+
10906	scaffold_117	77869	78858	989	101	yes	335930	+
10907	scaffold_117	86143	87035	892	58	yes	29261	-
10908	scaffold_117	93527	94536	1009	114	yes	398818	-
10909	scaffold_117	95815	95859	44	6	no	NA	NA
10910	scaffold_117	96055	96948	893	120	yes	335936	-
10911	scaffold_117	100973	102187	1214	128	yes	29296,335940	-,+
10912	scaffold_117	104977	106059	1082	140	yes	335941,335944	+,+
10913	scaffold_117	110807	112142	1335	171	yes	335946	-
10914	scaffold_117	113606	114799	1193	152	yes	335949	+
10915	scaffold_117	116237	117201	964	151	yes	335953	+
10916	scaffold_117	121978	123470	1492	164	yes	335954	-
10917	scaffold_177	12303	13705	1402	164	yes	303706,414239	-,-
10918	scaffold_231	3966	4005	39	12	no	NA	NA
10919	scaffold_231	14936	14984	48	11	no	NA	NA
10920	scaffold_74	1594	1633	39	12	no	NA	NA
10921	scaffold_74	14386	15230	844	94	yes	171284	-
10922	scaffold_74	31349	32422	1073	129	yes	332086,332088	-,+
10923	scaffold_74	41142	41777	635	73	no	NA	NA
10924	scaffold_74	41923	41942	19	3	yes	301303	+
10925	scaffold_74	62825	64270	1445	177	yes	397427	-
10926	scaffold_74	68093	68678	585	61	yes	397429	-
10927	scaffold_74	73637	74734	1097	138	yes	332108,332110	-,+
10928	scaffold_74	75220	76427	1207	127	yes	332108,332110	-,+
10929	scaffold_74	77518	78853	1335	168	no	NA	NA
10930	scaffold_74	82218	83744	1526	148	yes	332115	+
10931	scaffold_74	84886	86464	1578	119	yes	171432	+
10932	scaffold_74	90538	92225	1687	184	yes	381265	-
10933	scaffold_74	100272	100953	681	21	yes	224229	-
10934	scaffold_74	102547	103816	1269	139	yes	399872	+
10935	scaffold_74	109589	110802	1213	140	yes	301328	-
10936	scaffold_74	111395	112719	1324	146	yes	397442	+
10937	scaffold_74	127330	128553	1223	88	yes	171515,332129	-,+
10938	scaffold_74	189074	189144	70	11	yes	237185	-
10939	scaffold_74	189322	189338	16	6	yes	237185	-
10940	scaffold_74	198050	199562	1512	161	yes	430931	+
10941	scaffold_74	205599	206934	1335	146	yes	332176	-
10942	scaffold_74	216822	216836	14	4	no	NA	NA
10943	scaffold_74	216940	217613	673	87	yes	332181	-
10944	scaffold_74	217693	217910	217	18	yes	332181	-
10945	scaffold_74	222864	224121	1257	141	yes	332182	+
10946	scaffold_74	229965	230940	975	81	yes	332184	+
10947	scaffold_74	250840	250847	7	4	no	NA	NA
10948	scaffold_74	256603	257910	1307	143	yes	171738,171750	-,+
10949	scaffold_74	258220	259165	945	108	yes	171750	+
10950	scaffold_74	261351	261920	569	51	yes	332194	-
10951	scaffold_74	262053	262219	166	18	yes	332194,332195	-,+
10952	scaffold_74	262786	263786	1000	93	yes	332194,332195	-,+
10953	scaffold_74	266150	266178	28	8	no	NA	NA
10954	scaffold_74	266299	267129	830	125	yes	332197	-
10955	scaffold_74	270897	272550	1653	227	yes	224201	-
10956	scaffold_74	284114	284349	235	12	no	NA	NA
10957	scaffold_74	292154	292873	719	96	no	NA	NA
10958	scaffold_74	297780	299082	1302	154	yes	332215	-
10959	scaffold_74	301804	301843	39	6	no	NA	NA
10960	scaffold_74	302456	303532	1076	108	yes	332219	+
10961	scaffold_74	309864	310935	1071	137	yes	249576	-
10962	scaffold_74	312845	313817	972	86	yes	171940	+
10963	scaffold_74	323438	324114	676	72	yes	332224,332226	-,+
10964	scaffold_74	324162	324209	47	10	yes	332224,332226	-,+
10965	scaffold_74	324479	325247	768	95	yes	332224,332226	-,+
10966	scaffold_74	332809	334135	1326	143	yes	301376,430959	+,+
10967	scaffold_113	3205	3244	39	12	no	NA	NA
10968	scaffold_113	7902	7921	19	6	no	NA	NA
10969	scaffold_113	13414	13472	58	18	no	NA	NA
10970	scaffold_113	14138	14213	75	20	no	NA	NA
10971	scaffold_113	23079	23101	22	8	no	NA	NA
10972	scaffold_113	23209	23249	40	12	no	NA	NA
10973	scaffold_113	23357	23571	214	32	no	NA	NA
10974	scaffold_113	25218	25267	49	14	no	NA	NA
10975	scaffold_113	47372	47582	210	11	no	NA	NA
10976	scaffold_113	47697	48942	1245	165	yes	335604	-
10977	scaffold_113	49573	50589	1016	99	no	NA	NA
10978	scaffold_113	115322	115341	19	6	no	NA	NA
10979	scaffold_113	132146	133215	1069	106	no	NA	NA
10980	scaffold_179	3024	3046	22	3	no	NA	NA
10981	scaffold_179	3125	3166	41	10	no	NA	NA
10982	scaffold_179	4205	5963	1758	184	yes	432773	+
10983	scaffold_179	9700	9903	203	26	no	NA	NA
10984	scaffold_179	10386	10448	62	14	no	NA	NA
10985	scaffold_179	11439	11918	479	41	no	NA	NA
10986	scaffold_179	12397	12424	27	8	no	NA	NA
10987	scaffold_75	2887	3522	635	74	no	NA	NA
10988	scaffold_75	17371	18459	1088	118	no	NA	NA
10989	scaffold_75	19912	19954	42	12	yes	249583	+
10990	scaffold_75	20403	21798	1395	136	yes	249583	+
10991	scaffold_75	21913	21932	19	4	no	NA	NA
10992	scaffold_75	27594	29256	1662	122	yes	301381	+
10993	scaffold_75	39045	39064	19	8	no	NA	NA
10994	scaffold_75	50261	51521	1260	156	yes	301385	-
10995	scaffold_75	52802	52812	10	6	no	NA	NA
10996	scaffold_75	58196	59619	1423	162	no	NA	NA
10997	scaffold_75	63711	64964	1253	102	yes	172085	-
10998	scaffold_75	69303	69458	155	18	yes	301388	+
10999	scaffold_75	69844	70000	156	4	yes	301388	+
11000	scaffold_75	81058	82337	1279	136	yes	224331	-
11001	scaffold_75	102010	102027	17	4	no	NA	NA
11002	scaffold_75	124546	126478	1932	213	no	NA	NA
11003	scaffold_75	126648	126794	146	22	no	NA	NA
11004	scaffold_75	130905	131985	1080	82	yes	332311	+
11005	scaffold_75	135129	135194	65	10	no	NA	NA
11006	scaffold_75	139228	140738	1510	102	yes	237245	-
11007	scaffold_75	168820	168830	10	4	yes	416078	-
11008	scaffold_75	187324	188643	1319	109	yes	172277	+
11009	scaffold_75	190293	191090	797	62	yes	386155	-
11010	scaffold_75	196931	197421	490	68	yes	332342	-
11011	scaffold_75	197532	197907	375	56	yes	332342	-
11012	scaffold_75	202694	204024	1330	179	yes	301412	-
11013	scaffold_75	206291	207772	1481	129	yes	416089	+
11014	scaffold_75	212143	213176	1033	72	yes	416090	-
11015	scaffold_75	215825	216976	1151	142	yes	332349	-
11016	scaffold_75	218916	219905	989	109	yes	332350	-
11017	scaffold_75	229361	230315	954	112	yes	397517	-
11018	scaffold_75	232074	233161	1087	110	yes	332359	+
11019	scaffold_75	235031	236554	1523	205	yes	332360,332364	+,+
11020	scaffold_75	241515	242147	632	100	yes	431002	-
11021	scaffold_75	243845	244628	783	100	yes	431003	-
11022	scaffold_75	255464	256689	1225	139	yes	332374	+
11023	scaffold_75	262554	263521	967	31	yes	332375	+
11024	scaffold_75	270739	270957	218	22	yes	416104	+
11025	scaffold_75	277506	278488	982	162	yes	386158	+
11026	scaffold_75	283468	283502	34	7	no	NA	NA
11027	scaffold_75	283664	284978	1314	159	yes	332385	-
11028	scaffold_75	294509	295830	1321	132	yes	332387	+
11029	scaffold_75	297319	298261	942	117	yes	431011	-
11030	scaffold_75	300498	301903	1405	162	yes	237269	-
11031	scaffold_75	302799	303406	607	47	yes	397532	+
11032	scaffold_75	306564	307834	1270	146	yes	332394	+
11033	scaffold_75	314668	314736	68	4	yes	332397	+
11034	scaffold_75	314952	315124	172	28	yes	332397	+
11035	scaffold_75	315210	315454	244	14	no	NA	NA
11036	scaffold_75	316856	316883	27	8	no	NA	NA
11037	scaffold_75	317019	317827	808	62	yes	332399	-
11038	scaffold_75	317944	317965	21	8	yes	332399	-
11039	scaffold_75	319504	319973	469	51	yes	332404	-
11040	scaffold_75	320038	320433	395	40	yes	332404	-
11041	scaffold_75	323283	324364	1081	101	yes	301442	+
11042	scaffold_111	1809	2443	634	57	yes	302968	+
11043	scaffold_111	5760	6237	477	23	no	NA	NA
11044	scaffold_111	6585	6937	352	23	yes	335453	-
11045	scaffold_111	14577	15995	1418	161	yes	335455	-
11046	scaffold_111	17822	18466	644	62	yes	335456	+
11047	scaffold_111	33450	34171	721	83	yes	335461	+
11048	scaffold_111	34350	34394	44	3	no	NA	NA
11049	scaffold_111	38075	39397	1322	149	yes	335467	+
11050	scaffold_111	46618	47285	667	67	yes	302978	+
11051	scaffold_111	50568	51910	1342	87	yes	335472	-
11052	scaffold_111	57033	58108	1075	82	yes	398672	+
11053	scaffold_111	60274	61729	1455	148	yes	302981	+
11054	scaffold_111	70243	71330	1087	144	no	NA	NA
11055	scaffold_111	71402	71422	20	8	no	NA	NA
11056	scaffold_111	71549	71744	195	10	no	NA	NA
11057	scaffold_111	85796	87243	1447	173	yes	335483	-
11058	scaffold_111	88867	89984	1117	132	yes	335486	-
11059	scaffold_111	93245	94326	1081	156	yes	335489,335492	-,+
11060	scaffold_111	94505	95953	1448	158	yes	335489,335492	-,+
11061	scaffold_111	99623	100639	1016	119	yes	398681	-
11062	scaffold_111	101571	102810	1239	132	yes	302991	+
11063	scaffold_111	109847	111289	1442	158	yes	27139,335500	+,+
11064	scaffold_111	113652	113657	5	4	yes	335501	+
11065	scaffold_111	119157	119985	828	56	yes	335504	-
11066	scaffold_111	124874	125618	744	103	no	NA	NA
11067	scaffold_111	131044	132116	1072	134	yes	335508,398691	-,+
11068	scaffold_111	135837	135848	11	4	yes	335510	+
11069	scaffold_111	136028	137569	1541	148	yes	335510	+
11070	scaffold_111	153655	154826	1171	136	yes	398694	-
11071	scaffold_76	12167	13143	976	60	yes	332411	-
11072	scaffold_76	43392	44346	954	83	yes	332421	+
11073	scaffold_76	82287	82893	606	54	no	NA	NA
11074	scaffold_76	98172	98547	375	20	yes	332432	+
11075	scaffold_76	107049	107061	12	6	no	NA	NA
11076	scaffold_76	147530	148279	749	80	yes	332443	+
11077	scaffold_76	162264	163758	1494	158	no	NA	NA
11078	scaffold_76	164191	164923	732	100	no	NA	NA
11079	scaffold_76	176737	178041	1304	121	no	NA	NA
11080	scaffold_76	191861	192272	411	36	yes	172892	+
11081	scaffold_76	192547	192563	16	4	no	NA	NA
11082	scaffold_76	194745	195719	974	78	yes	397558	+
11083	scaffold_76	227208	228370	1162	94	yes	332464	-
11084	scaffold_76	233982	234992	1010	70	yes	409697	-
11085	scaffold_76	236808	237021	213	12	yes	332467	+
11086	scaffold_76	237117	237365	248	41	yes	332467	+
11087	scaffold_76	253091	253709	618	56	yes	397567	+
11088	scaffold_76	262728	264078	1350	176	yes	332474	-
11089	scaffold_76	265792	266874	1082	70	yes	332476	-
11090	scaffold_76	274710	275920	1210	141	yes	332481	+
11091	scaffold_76	279362	279872	510	72	yes	173001	-
11092	scaffold_76	288354	288364	10	4	no	NA	NA
11093	scaffold_76	305413	305670	257	30	no	NA	NA
11094	scaffold_76	305819	306399	580	81	yes	332513	-
11095	scaffold_76	306720	307385	665	74	yes	332513	-
11096	scaffold_76	308595	308630	35	4	no	NA	NA
11097	scaffold_76	308729	309550	821	88	yes	173071,409717	-,+
11098	scaffold_76	316899	317906	1007	35	yes	381438	+
11099	scaffold_76	323997	325320	1323	63	yes	332529	-
11100	scaffold_81	1563	3174	1611	167	yes	301739,332906	+,+
11101	scaffold_81	18916	20115	1199	112	yes	431267	+
11102	scaffold_81	20232	20293	61	14	no	NA	NA
11103	scaffold_81	26809	27419	610	42	no	NA	NA
11104	scaffold_81	28937	29750	813	79	yes	332920	+
11105	scaffold_81	29930	30123	193	14	yes	332920	+
11106	scaffold_81	38398	39288	890	95	no	NA	NA
11107	scaffold_81	40138	41262	1124	143	yes	332925	+
11108	scaffold_81	46078	47362	1284	112	yes	249821	-
11109	scaffold_81	51099	51112	13	4	no	NA	NA
11110	scaffold_81	51270	52029	759	65	yes	181019	-
11111	scaffold_81	57430	58267	837	101	yes	332929	-
11112	scaffold_81	59518	60875	1357	150	yes	399985	+
11113	scaffold_81	66495	67522	1027	127	yes	332936	-
11114	scaffold_81	68712	69923	1211	134	yes	332939	-
11115	scaffold_81	71027	72441	1414	248	yes	181128	+
11116	scaffold_81	78155	79312	1157	126	yes	399989	+
11117	scaffold_81	105366	105695	329	52	yes	301758	+
11118	scaffold_81	121466	121921	455	54	yes	224567	-
11119	scaffold_81	122213	122974	761	54	no	NA	NA
11120	scaffold_81	129021	129914	893	100	yes	332960	-
11121	scaffold_81	138152	139572	1420	151	yes	332965	-
11122	scaffold_81	147722	147773	51	11	no	NA	NA
11123	scaffold_81	152906	154263	1357	153	yes	332978	-
11124	scaffold_81	158577	159512	935	70	yes	400002	+
11125	scaffold_81	164848	166028	1180	96	yes	301766	+
11126	scaffold_81	170742	170928	186	10	no	NA	NA
11127	scaffold_81	171062	171181	119	16	yes	332983	-
11128	scaffold_81	173952	175345	1393	173	no	NA	NA
11129	scaffold_81	177837	178939	1102	151	yes	397798	-
11130	scaffold_81	181066	182496	1430	141	yes	301769	-
11131	scaffold_81	204048	204059	11	4	yes	333001	+
11132	scaffold_81	233996	234588	592	71	yes	333009	+
11133	scaffold_81	237073	237928	855	92	yes	181586	-
11134	scaffold_81	252797	253624	827	60	yes	333023	-
11135	scaffold_81	278903	279727	824	76	yes	301786	+
11136	scaffold_81	283692	284326	634	59	no	NA	NA
11137	scaffold_81	284473	284484	11	6	no	NA	NA
11138	scaffold_81	286998	288473	1475	185	yes	382083	+
11139	scaffold_112	6112	6157	45	16	no	NA	NA
11140	scaffold_112	22285	22940	655	66	yes	432241	-
11141	scaffold_112	27918	28916	998	137	yes	303010	-
11142	scaffold_112	30590	31610	1020	129	yes	405560	-
11143	scaffold_112	62683	63929	1246	137	yes	432250	-
11144	scaffold_112	67115	67187	72	12	no	NA	NA
11145	scaffold_112	67639	69428	1789	198	no	NA	NA
11146	scaffold_112	69527	69560	33	5	no	NA	NA
11147	scaffold_112	77459	78493	1034	94	yes	405568	+
11148	scaffold_112	82646	83637	991	88	yes	398710	+
11149	scaffold_112	83715	84177	462	48	no	NA	NA
11150	scaffold_112	90654	91669	1015	120	yes	335554	-
11151	scaffold_112	93708	94195	487	50	yes	335557	-
11152	scaffold_112	112599	113544	945	123	yes	335558	-
11153	scaffold_112	129868	131173	1305	133	yes	405575	-
11154	scaffold_112	139282	141390	2108	156	no	NA	NA
11155	scaffold_112	144092	145996	1904	113	no	NA	NA
11156	scaffold_77	4728	4747	19	6	no	NA	NA
11157	scaffold_77	8312	8908	596	57	yes	332536	+
11158	scaffold_77	9057	9114	57	3	yes	332536	+
11159	scaffold_77	15891	16937	1046	125	yes	332539	+
11160	scaffold_77	20347	21511	1164	128	yes	173170	+
11161	scaffold_77	27375	28715	1340	159	yes	332541	-
11162	scaffold_77	30569	31931	1362	164	yes	332543	-
11163	scaffold_77	45624	45658	34	6	no	NA	NA
11164	scaffold_77	45782	46800	1018	116	no	NA	NA
11165	scaffold_77	51356	52787	1431	150	yes	332548	+
11166	scaffold_77	56908	56935	27	5	yes	431072	+
11167	scaffold_77	63972	64531	559	39	yes	431073	-
11168	scaffold_77	72368	73381	1013	152	yes	381464	+
11169	scaffold_77	96948	96968	20	4	no	NA	NA
11170	scaffold_77	98572	98579	7	4	yes	249663	+
11171	scaffold_77	110364	111545	1181	108	yes	397602	-
11172	scaffold_77	133404	134251	847	98	no	NA	NA
11173	scaffold_77	164664	165728	1064	100	yes	224367	+
11174	scaffold_77	175875	176955	1080	103	yes	332585	-
11175	scaffold_77	213120	214415	1295	138	yes	406660	-
11176	scaffold_77	215085	216551	1466	163	yes	173643	-
11177	scaffold_77	217186	218176	990	113	yes	332598	+
11178	scaffold_77	222974	224378	1404	115	yes	332600	-
11179	scaffold_77	229703	230839	1136	139	yes	332601	-
11180	scaffold_77	231627	232526	899	119	yes	332604	+
11181	scaffold_77	237167	238396	1229	145	no	NA	NA
11182	scaffold_77	242628	243643	1015	120	yes	431105	-
11183	scaffold_77	245629	247263	1634	161	yes	301552	+
11184	scaffold_77	252277	253609	1332	87	yes	332612	+
11185	scaffold_77	254905	256249	1344	172	yes	332614	+
11186	scaffold_77	261920	263279	1359	168	yes	397627,406671	+,-
11187	scaffold_77	272170	273073	903	83	yes	332621	-
11188	scaffold_77	273597	274440	843	104	no	NA	NA
11189	scaffold_77	280516	282218	1702	181	yes	332622	-
11190	scaffold_77	283445	284369	924	124	yes	381490	+
11191	scaffold_77	284484	284500	16	4	no	NA	NA
11192	scaffold_77	304229	305541	1312	168	yes	381499	-
11193	scaffold_77	307760	308724	964	110	yes	332629	-
11194	scaffold_77	310889	311826	937	121	yes	431115	-
11195	scaffold_77	315054	316306	1252	113	yes	224410	+
11196	scaffold_77	324825	325164	339	24	no	NA	NA
11197	scaffold_80	24103	24115	12	4	yes	381906	+
11198	scaffold_80	36060	37592	1532	118	yes	332832	-
11199	scaffold_80	39526	40821	1295	152	no	NA	NA
11200	scaffold_80	48636	50181	1545	170	yes	332837,332840	-,+
11201	scaffold_80	71489	72753	1264	156	no	NA	NA
11202	scaffold_80	75547	75842	295	15	yes	397737	+
11203	scaffold_80	76285	76292	7	4	no	NA	NA
11204	scaffold_80	76656	78158	1502	186	no	NA	NA
11205	scaffold_80	79469	79887	418	58	yes	332845	-
11206	scaffold_80	80177	80216	39	12	yes	332845	-
11207	scaffold_80	80323	80736	413	56	yes	332845	-
11208	scaffold_80	87332	87866	534	56	yes	249789	-
11209	scaffold_80	110779	110794	15	8	yes	381964	+
11210	scaffold_80	116648	117731	1083	77	yes	381969	+
11211	scaffold_80	132862	133831	969	101	yes	397748	-
11212	scaffold_80	144449	144857	408	50	no	NA	NA
11213	scaffold_80	144927	145043	116	20	no	NA	NA
11214	scaffold_80	145117	145177	60	10	no	NA	NA
11215	scaffold_80	169850	169875	25	4	yes	397753	-
11216	scaffold_80	170056	170846	790	62	yes	397753	-
11217	scaffold_80	176504	176976	472	34	yes	180586	+
11218	scaffold_80	197550	198534	984	95	yes	332870	-
11219	scaffold_80	201667	202665	998	95	yes	431245	+
11220	scaffold_80	204937	205515	578	58	no	NA	NA
11221	scaffold_80	221730	221914	184	12	no	NA	NA
11222	scaffold_80	227201	227810	609	69	yes	332881	+
11223	scaffold_80	227891	227913	22	8	no	NA	NA
11224	scaffold_80	230699	232240	1541	162	yes	301727	-
11225	scaffold_80	232773	232785	12	4	no	NA	NA
11226	scaffold_80	232993	233873	880	107	yes	332888	-
11227	scaffold_80	264808	265425	617	66	yes	397768	-
11228	scaffold_80	270365	271421	1056	117	no	NA	NA
11229	scaffold_108	4767	5678	911	71	yes	335064	-
11230	scaffold_108	9138	10546	1408	153	yes	250458	+
11231	scaffold_108	14163	15369	1206	110	yes	335076	-
11232	scaffold_108	16079	17461	1382	144	yes	225298	+
11233	scaffold_108	22125	23432	1307	177	yes	335085	+
11234	scaffold_108	26176	27426	1250	100	yes	335088	+
11235	scaffold_108	29790	31181	1391	157	yes	335092	-
11236	scaffold_108	46937	47751	814	75	yes	410521	+
11237	scaffold_108	68472	69615	1143	113	yes	335111	+
11238	scaffold_108	72950	73652	702	62	yes	335112	+
11239	scaffold_108	77181	77192	11	4	no	NA	NA
11240	scaffold_108	77823	78798	975	61	yes	23207,23219	+,+
11241	scaffold_108	82133	83672	1539	139	yes	367913	+
11242	scaffold_108	93761	94626	865	58	yes	410530	-
11243	scaffold_108	108371	109696	1325	124	yes	302882	+
11244	scaffold_108	112863	113619	756	62	yes	398600	+
11245	scaffold_108	114090	115216	1126	126	yes	398600	+
11246	scaffold_108	117427	118448	1021	133	yes	335123	+
11247	scaffold_108	118753	118763	10	4	no	NA	NA
11248	scaffold_108	122368	122641	273	26	no	NA	NA
11249	scaffold_108	122800	122906	106	12	no	NA	NA
11250	scaffold_108	123351	123476	125	6	yes	335125	-
11251	scaffold_108	128091	129388	1297	141	yes	302886	-
11252	scaffold_108	133114	133567	453	69	yes	302887	+
11253	scaffold_108	134212	134220	8	4	no	NA	NA
11254	scaffold_108	138465	139548	1083	110	yes	335295	+
11255	scaffold_108	143923	144795	872	131	yes	398606	-
11256	scaffold_108	153761	154538	777	53	yes	398609	-
11257	scaffold_108	160450	160952	502	67	yes	335302	-
11258	scaffold_108	162616	162622	6	3	no	NA	NA
11259	scaffold_108	167281	168365	1084	114	yes	398611	-
11260	scaffold_108	171812	172734	922	82	yes	335310	-
11261	scaffold_108	180204	180511	307	30	yes	335311	+
11262	scaffold_108	180601	180935	334	36	yes	335311	+
11263	scaffold_414	521	981	460	44	no	NA	NA
11264	scaffold_78	67967	69262	1295	172	yes	397638	+
11265	scaffold_78	71031	71062	31	8	no	NA	NA
11266	scaffold_78	101652	102512	860	109	yes	174049	-
11267	scaffold_78	108358	110039	1681	190	yes	332659	-
11268	scaffold_78	115549	117135	1586	174	yes	174090	-
11269	scaffold_78	120547	121457	910	107	no	NA	NA
11270	scaffold_78	130080	131253	1173	106	no	NA	NA
11271	scaffold_78	132013	133208	1195	145	yes	332665,332668	+,+
11272	scaffold_78	133561	134605	1044	132	yes	332668	+
11273	scaffold_78	154402	155831	1429	184	yes	332675	-
11274	scaffold_78	156670	157740	1070	94	yes	332677	+
11275	scaffold_78	163826	164293	467	60	yes	174254	+
11276	scaffold_78	191533	192668	1135	97	yes	332684	+
11277	scaffold_78	193152	193933	781	84	no	NA	NA
11278	scaffold_78	196212	198169	1957	181	no	NA	NA
11279	scaffold_78	198614	200287	1673	155	yes	397656	-
11280	scaffold_78	200473	200508	35	8	yes	397656	-
11281	scaffold_78	208357	209437	1080	119	yes	224455	-
11282	scaffold_78	214088	214989	901	69	yes	332694	-
11283	scaffold_78	220456	221560	1104	86	no	NA	NA
11284	scaffold_78	222097	223063	966	109	yes	399654	-
11285	scaffold_78	225409	226455	1046	112	yes	332701	+
11286	scaffold_78	226534	226634	100	20	yes	332701	+
11287	scaffold_78	242946	243640	694	52	yes	397662	+
11288	scaffold_78	248432	250222	1790	176	no	NA	NA
11289	scaffold_78	251390	251437	47	5	no	NA	NA
11290	scaffold_78	251558	251899	341	37	no	NA	NA
11291	scaffold_78	252154	252267	113	7	no	NA	NA
11292	scaffold_78	253676	254983	1307	119	yes	397664	+
11293	scaffold_78	259327	259772	445	36	no	NA	NA
11294	scaffold_78	263383	263486	103	20	no	NA	NA
11295	scaffold_78	290268	290281	13	4	yes	399666	-
11296	scaffold_78	291222	291230	8	4	no	NA	NA
11297	scaffold_78	310170	310621	451	59	no	NA	NA
11298	scaffold_79	15910	17463	1553	186	yes	332719	-
11299	scaffold_79	18923	18947	24	6	no	NA	NA
11300	scaffold_79	57354	57427	73	14	yes	381581	-
11301	scaffold_79	65276	65307	31	9	yes	381591	-
11302	scaffold_79	87842	87966	124	20	yes	332738	+
11303	scaffold_79	91988	92978	990	132	yes	381609	-
11304	scaffold_79	100539	100577	38	6	no	NA	NA
11305	scaffold_79	108369	109686	1317	143	no	NA	NA
11306	scaffold_79	115079	115086	7	4	no	NA	NA
11307	scaffold_79	115335	116340	1005	128	yes	431175,431176	-,+
11308	scaffold_79	120027	120854	827	100	no	NA	NA
11309	scaffold_79	128692	129646	954	127	yes	332748	-
11310	scaffold_79	133356	133944	588	63	yes	174764	-
11311	scaffold_79	139940	141085	1145	104	yes	332750	+
11312	scaffold_79	143812	144663	851	101	yes	397696	+
11313	scaffold_79	146307	147194	887	101	no	NA	NA
11314	scaffold_79	149425	150206	781	90	no	NA	NA
11315	scaffold_79	150368	150380	12	4	no	NA	NA
11316	scaffold_79	168557	169682	1125	117	yes	431187	+
11317	scaffold_79	198986	200152	1166	149	yes	332769	+
11318	scaffold_79	206651	207090	439	58	no	NA	NA
11319	scaffold_79	216996	218687	1691	215	yes	397705	-
11320	scaffold_79	237506	237520	14	4	no	NA	NA
11321	scaffold_79	237635	238218	583	47	yes	397710,431197	-,+
11322	scaffold_79	238578	239694	1116	144	yes	397710,431197	-,+
11323	scaffold_79	251287	251693	406	25	yes	332786	+
11324	scaffold_79	251773	252091	318	34	yes	332786	+
11325	scaffold_79	271070	272976	1906	221	yes	332795	+
11326	scaffold_79	275801	275860	59	8	no	NA	NA
11327	scaffold_79	276014	276769	755	70	yes	175842	-
11328	scaffold_79	288307	288916	609	65	no	NA	NA
11329	scaffold_79	289092	289117	25	3	no	NA	NA
11330	scaffold_79	291247	292508	1261	151	no	NA	NA
